name_profile,drug,dose,time,nsamples_trt,nsamples_ctl,sample_size,n_batch,ss_genes,UP,DOWN,cell_iname
vorinostat_10uM_24h,vorinostat,10 uM,24 h,99,1239,1338,27,844,427,417,NPC
sirolimus_10uM_24h,sirolimus,10 uM,24 h,57,1005,1062,19,565,228,337,NPC
resveratrol_10uM_24h,resveratrol,10 uM,24 h,32,368,400,7,165,61,104,NPC
riluzole_10uM_24h,riluzole,10 uM,24 h,29,452,481,10,245,90,155,NPC
dasatinib_10uM_24h,dasatinib,10 uM,24 h,28,609,637,10,354,135,219,NPC
dasatinib_0.04uM_24h,dasatinib,0.04 uM,24 h,25,592,617,9,164,82,82,NPC
dasatinib_0.12uM_24h,dasatinib,0.12 uM,24 h,25,592,617,9,155,79,76,NPC
dasatinib_0.37uM_24h,dasatinib,0.37 uM,24 h,25,592,617,9,239,88,151,NPC
dasatinib_1.11uM_24h,dasatinib,1.11 uM,24 h,25,592,617,9,238,87,151,NPC
decitabine_10uM_24h,decitabine,10 uM,24 h,24,320,344,6,147,74,73,NPC
dasatinib_3.33uM_24h,dasatinib,3.33 uM,24 h,24,564,588,9,204,87,117,NPC
dopamine_10uM_24h,dopamine,10 uM,24 h,23,49,72,3,16,2,14,NPC
vorinostat_10uM_6h,vorinostat,10 uM,6 h,22,69,91,4,446,201,245,NPC
resveratrol_10uM_6h,resveratrol,10 uM,6 h,21,32,53,3,47,10,37,NPC
tranylcypromine_10uM_24h,tranylcypromine,10 uM,24 h,20,344,364,7,0,0,0,NPC
forskolin_10uM_24h,forskolin,10 uM,24 h,20,62,82,3,154,35,119,NPC
dopamine_10uM_6h,dopamine,10 uM,6 h,20,39,59,2,0,0,0,NPC
tamoxifen_10uM_24h,tamoxifen,10 uM,24 h,20,79,99,3,141,26,115,NPC
tretinoin_10uM_24h,tretinoin,10 uM,24 h,19,91,110,4,25,17,8,NPC
valproic-acid_10uM_6h,valproic-acid,10 uM,6 h,18,30,48,2,305,86,219,NPC
olaparib_10uM_24h,olaparib,10 uM,24 h,18,441,459,6,310,161,149,NPC
retinol_10uM_24h,retinol,10 uM,24 h,18,71,89,3,36,7,29,NPC
pregnenolone_10uM_24h,pregnenolone,10 uM,24 h,18,79,97,4,8,2,6,NPC
olaparib_0.04uM_24h,olaparib,0.04 uM,24 h,18,441,459,6,14,4,10,NPC
olaparib_0.37uM_24h,olaparib,0.37 uM,24 h,18,441,459,6,13,10,3,NPC
olaparib_1.11uM_24h,olaparib,1.11 uM,24 h,18,441,459,6,31,21,10,NPC
olaparib_3.33uM_24h,olaparib,3.33 uM,24 h,18,441,459,6,60,39,21,NPC
estradiol_10uM_24h,estradiol,10 uM,24 h,17,87,104,4,269,100,169,NPC
valproic-acid_10uM_24h,valproic-acid,10 uM,24 h,17,54,71,2,401,105,296,NPC
dexamethasone_10uM_24h,dexamethasone,10 uM,24 h,17,121,138,5,72,15,57,NPC
olaparib_0.12uM_24h,olaparib,0.12 uM,24 h,17,420,437,6,12,8,4,NPC
oxiracetam_30uM_24h,oxiracetam,30 uM,24 h,15,347,362,5,6,6,0,NPC
tianeptine_30uM_24h,tianeptine,30 uM,24 h,15,347,362,5,22,10,12,NPC
oxiracetam_125uM_24h,oxiracetam,125 uM,24 h,15,347,362,5,15,9,6,NPC
tianeptine_125uM_24h,tianeptine,125 uM,24 h,15,347,362,5,45,37,8,NPC
serotonin_10uM_6h,serotonin,10 uM,6 h,15,39,54,2,0,0,0,NPC
serotonin_10uM_24h,serotonin,10 uM,24 h,15,41,56,2,184,83,101,NPC
imatinib_10uM_24h,imatinib,10 uM,24 h,15,71,86,3,24,8,16,NPC
decitabine_10uM_6h,decitabine,10 uM,6 h,15,32,47,3,90,24,66,NPC
tetrabenazine_10uM_24h,tetrabenazine,10 uM,24 h,15,41,56,2,73,27,46,NPC
roflumilast_10uM_24h,roflumilast,10 uM,24 h,15,347,362,5,5,1,4,NPC
tetrabenazine_10uM_6h,tetrabenazine,10 uM,6 h,15,39,54,2,0,0,0,NPC
doconexent_10uM_24h,doconexent,10 uM,24 h,15,62,77,3,0,0,0,NPC
vorinostat_1.11uM_24h,vorinostat,1.11 uM,24 h,15,340,355,5,297,146,151,NPC
vorinostat_3.33uM_24h,vorinostat,3.33 uM,24 h,15,340,355,5,466,211,255,NPC
tretinoin_3.33uM_24h,tretinoin,3.33 uM,24 h,15,347,362,5,129,77,52,NPC
isradipine_3.33uM_24h,isradipine,3.33 uM,24 h,15,347,362,5,100,44,56,NPC
pramipexole_3.33uM_24h,pramipexole,3.33 uM,24 h,15,347,362,5,3,3,0,NPC
fluoxetine_3.33uM_24h,fluoxetine,3.33 uM,24 h,15,347,362,5,6,3,3,NPC
ziprasidone_3.33uM_24h,ziprasidone,3.33 uM,24 h,15,347,362,5,26,13,13,NPC
aripiprazole_3.33uM_24h,aripiprazole,3.33 uM,24 h,15,347,362,5,9,4,5,NPC
quetiapine_3.33uM_24h,quetiapine,3.33 uM,24 h,15,347,362,5,25,11,14,NPC
topiramate_3.33uM_24h,topiramate,3.33 uM,24 h,15,347,362,5,4,4,0,NPC
amitriptyline_3.33uM_24h,amitriptyline,3.33 uM,24 h,15,347,362,5,29,14,15,NPC
lamotrigine_3.33uM_24h,lamotrigine,3.33 uM,24 h,15,347,362,5,4,2,2,NPC
topotecan_3.33uM_24h,topotecan,3.33 uM,24 h,15,347,362,5,787,388,399,NPC
doconexent_3.33uM_24h,doconexent,3.33 uM,24 h,15,347,362,5,246,112,134,NPC
clozapine_3.33uM_24h,clozapine,3.33 uM,24 h,15,347,362,5,3,1,2,NPC
olanzapine_3.33uM_24h,olanzapine,3.33 uM,24 h,15,347,362,5,1,1,0,NPC
simvastatin_3.33uM_24h,simvastatin,3.33 uM,24 h,15,347,362,5,241,105,136,NPC
verapamil_3.33uM_24h,verapamil,3.33 uM,24 h,15,347,362,5,5,4,1,NPC
duloxetine_3.33uM_24h,duloxetine,3.33 uM,24 h,15,347,362,5,61,40,21,NPC
varenicline_3.33uM_24h,varenicline,3.33 uM,24 h,15,347,362,5,0,0,0,NPC
lurasidone_3.33uM_24h,lurasidone,3.33 uM,24 h,15,347,362,5,26,3,23,NPC
risperidone_3.33uM_24h,risperidone,3.33 uM,24 h,15,347,362,5,0,0,0,NPC
fluvastatin_3.33uM_24h,fluvastatin,3.33 uM,24 h,15,347,362,5,288,116,172,NPC
tianeptine_60uM_24h,tianeptine,60 uM,24 h,14,323,337,5,37,24,13,NPC
oxiracetam_60uM_24h,oxiracetam,60 uM,24 h,14,321,335,5,4,3,1,NPC
niclosamide_10uM_24h,niclosamide,10 uM,24 h,14,62,76,3,520,178,342,NPC
quinidine_10uM_24h,quinidine,10 uM,24 h,14,99,113,4,3,1,2,NPC
nemonapride_10uM_24h,nemonapride,10 uM,24 h,14,61,75,3,6,2,4,NPC
flunarizine_3.33uM_24h,flunarizine,3.33 uM,24 h,14,326,340,5,4,2,2,NPC
agomelatine_3.33uM_24h,agomelatine,3.33 uM,24 h,14,323,337,5,2,2,0,NPC
citalopram_3.33uM_24h,citalopram,3.33 uM,24 h,14,323,337,5,0,0,0,NPC
haloperidol_3.33uM_24h,haloperidol,3.33 uM,24 h,14,322,336,5,4,4,0,NPC
bosutinib_10uM_24h,bosutinib,10 uM,24 h,13,197,210,5,654,269,385,NPC
mifepristone_10uM_24h,mifepristone,10 uM,24 h,13,82,95,4,201,67,134,NPC
pravastatin_10uM_24h,pravastatin,10 uM,24 h,13,91,104,4,13,11,2,NPC
vorinostat_0.37uM_24h,vorinostat,0.37 uM,24 h,13,284,297,5,77,39,38,NPC
sertraline_3.33uM_24h,sertraline,3.33 uM,24 h,13,299,312,5,52,37,15,NPC
doconexent_10uM_6h,doconexent,10 uM,6 h,12,30,42,2,366,103,263,NPC
tamoxifen_10uM_6h,tamoxifen,10 uM,6 h,12,30,42,2,289,98,191,NPC
imatinib_10uM_6h,imatinib,10 uM,6 h,12,30,42,2,138,51,87,NPC
sorafenib_10uM_24h,sorafenib,10 uM,24 h,12,71,83,3,334,148,186,NPC
tretinoin_10uM_6h,tretinoin,10 uM,6 h,12,30,42,2,41,14,27,NPC
danazol_10uM_24h,danazol,10 uM,24 h,12,45,57,2,315,128,187,NPC
scopolamine_10uM_24h,scopolamine,10 uM,24 h,12,70,82,3,0,0,0,NPC
belinostat_10uM_24h,belinostat,10 uM,24 h,12,266,278,4,656,327,329,NPC
forskolin_10uM_6h,forskolin,10 uM,6 h,12,30,42,2,145,35,110,NPC
curcumin_10uM_6h,curcumin,10 uM,6 h,12,30,42,2,248,68,180,NPC
retinol_10uM_6h,retinol,10 uM,6 h,12,30,42,2,89,30,59,NPC
sulindac_10uM_24h,sulindac,10 uM,24 h,12,54,66,2,0,0,0,NPC
pregnenolone_10uM_6h,pregnenolone,10 uM,6 h,12,30,42,2,4,1,3,NPC
sulindac_10uM_6h,sulindac,10 uM,6 h,12,30,42,2,0,0,0,NPC
niclosamide_10uM_6h,niclosamide,10 uM,6 h,12,30,42,2,192,69,123,NPC
curcumin_10uM_24h,curcumin,10 uM,24 h,11,54,65,2,90,31,59,NPC
diltiazem_10uM_24h,diltiazem,10 uM,24 h,11,58,69,3,4,2,2,NPC
tranylcypromine_10uM_6h,tranylcypromine,10 uM,6 h,11,69,80,4,0,0,0,NPC
ranitidine_10uM_24h,ranitidine,10 uM,24 h,11,33,44,2,1,0,1,NPC
doxepin_10uM_24h,doxepin,10 uM,24 h,11,33,44,2,21,7,14,NPC
resveratrol_0.04uM_24h,resveratrol,0.04 uM,24 h,11,289,300,4,12,5,7,NPC
resveratrol_0.37uM_24h,resveratrol,0.37 uM,24 h,11,289,300,4,5,4,1,NPC
resveratrol_1.11uM_24h,resveratrol,1.11 uM,24 h,11,289,300,4,10,6,4,NPC
resveratrol_3.33uM_24h,resveratrol,3.33 uM,24 h,11,289,300,4,5,3,2,NPC
fulvestrant_10uM_24h,fulvestrant,10 uM,24 h,10,116,126,3,9,3,6,NPC
diclofenac_10uM_24h,diclofenac,10 uM,24 h,10,79,89,3,4,0,4,NPC
nemonapride_10uM_6h,nemonapride,10 uM,6 h,10,39,49,2,0,0,0,NPC
progesterone_10uM_24h,progesterone,10 uM,24 h,10,74,84,3,253,97,156,NPC
nimodipine_10uM_24h,nimodipine,10 uM,24 h,10,79,89,3,0,0,0,NPC
bezafibrate_10uM_24h,bezafibrate,10 uM,24 h,10,79,89,3,1,1,0,NPC
pioglitazone_10uM_24h,pioglitazone,10 uM,24 h,10,79,89,3,28,5,23,NPC
zonisamide_10uM_6h,zonisamide,10 uM,6 h,10,39,49,2,0,0,0,NPC
riluzole_10uM_6h,riluzole,10 uM,6 h,10,60,70,4,18,2,16,NPC
celecoxib_10uM_24h,celecoxib,10 uM,24 h,10,79,89,3,206,57,149,NPC
carbamazepine_10uM_24h,carbamazepine,10 uM,24 h,10,79,89,3,170,35,135,NPC
caffeine_10uM_24h,caffeine,10 uM,24 h,10,79,89,3,2,1,1,NPC
everolimus_10uM_24h,everolimus,10 uM,24 h,10,168,178,4,218,59,159,NPC
zonisamide_10uM_24h,zonisamide,10 uM,24 h,10,41,51,2,57,16,41,NPC
estrone_10uM_24h,estrone,10 uM,24 h,10,79,89,3,63,15,48,NPC
pazopanib_10uM_24h,pazopanib,10 uM,24 h,10,168,178,4,327,137,190,NPC
masitinib_10uM_24h,masitinib,10 uM,24 h,10,168,178,4,575,240,335,NPC
isotretinoin_10uM_24h,isotretinoin,10 uM,24 h,9,71,80,3,23,11,12,NPC
chloroquine_10uM_24h,chloroquine,10 uM,24 h,9,62,71,3,4,1,3,NPC
simvastatin_10uM_24h,simvastatin,10 uM,24 h,9,66,75,3,36,21,15,NPC
rilmenidine_10uM_24h,rilmenidine,10 uM,24 h,9,62,71,3,2,0,2,NPC
azacitidine_10uM_24h,azacitidine,10 uM,24 h,9,249,258,3,414,199,215,NPC
tolazamide_10uM_24h,tolazamide,10 uM,24 h,9,62,71,3,0,0,0,NPC
spiperone_10uM_24h,spiperone,10 uM,24 h,9,61,70,3,213,94,119,NPC
reboxetine_10uM_24h,reboxetine,10 uM,24 h,9,66,75,3,12,7,5,NPC
verapamil_10uM_24h,verapamil,10 uM,24 h,9,62,71,3,2,0,2,NPC
acitretin_10uM_24h,acitretin,10 uM,24 h,9,71,80,3,44,12,32,NPC
calcitriol_10uM_24h,calcitriol,10 uM,24 h,9,71,80,3,136,33,103,NPC
alectinib_10uM_24h,alectinib,10 uM,24 h,9,192,201,3,68,33,35,NPC
calcifediol_10uM_24h,calcifediol,10 uM,24 h,9,71,80,3,245,88,157,NPC
regorafenib_10uM_24h,regorafenib,10 uM,24 h,9,192,201,3,355,166,189,NPC
loperamide_10uM_24h,loperamide,10 uM,24 h,9,62,71,3,35,14,21,NPC
pimozide_10uM_24h,pimozide,10 uM,24 h,9,62,71,3,276,123,153,NPC
nitrendipine_10uM_24h,nitrendipine,10 uM,24 h,9,62,71,3,0,0,0,NPC
clofibric-acid_10uM_24h,clofibric-acid,10 uM,24 h,9,67,76,3,0,0,0,NPC
fluvastatin_10uM_24h,fluvastatin,10 uM,24 h,9,66,75,3,70,25,45,NPC
fluspirilene_10uM_24h,fluspirilene,10 uM,24 h,9,62,71,3,191,73,118,NPC
dexamethasone_10uM_6h,dexamethasone,10 uM,6 h,9,32,41,3,39,6,33,NPC
cholic-acid_10uM_24h,cholic-acid,10 uM,24 h,9,71,80,3,0,0,0,NPC
clozapine_10uM_24h,clozapine,10 uM,24 h,9,66,75,3,250,82,168,NPC
thalidomide_10uM_24h,thalidomide,10 uM,24 h,9,62,71,3,0,0,0,NPC
lovastatin_10uM_24h,lovastatin,10 uM,24 h,9,66,75,3,27,17,10,NPC
dabrafenib_10uM_24h,dabrafenib,10 uM,24 h,9,192,201,3,83,53,30,NPC
minoxidil_10uM_24h,minoxidil,10 uM,24 h,9,62,71,3,4,3,1,NPC
risperidone_10uM_24h,risperidone,10 uM,24 h,9,66,75,3,1,0,1,NPC
azacitidine_0.04uM_24h,azacitidine,0.04 uM,24 h,9,249,258,3,72,55,17,NPC
decitabine_0.04uM_24h,decitabine,0.04 uM,24 h,9,249,258,3,26,17,9,NPC
belinostat_0.04uM_24h,belinostat,0.04 uM,24 h,9,249,258,3,265,118,147,NPC
regorafenib_0.04uM_24h,regorafenib,0.04 uM,24 h,9,192,201,3,2,1,1,NPC
tranylcypromine_0.04uM_24h,tranylcypromine,0.04 uM,24 h,9,249,258,3,2,0,2,NPC
dabrafenib_0.04uM_24h,dabrafenib,0.04 uM,24 h,9,192,201,3,19,17,2,NPC
alectinib_0.04uM_24h,alectinib,0.04 uM,24 h,9,192,201,3,98,53,45,NPC
vorinostat_0.04uM_24h,vorinostat,0.04 uM,24 h,9,249,258,3,6,4,2,NPC
resveratrol_0.12uM_24h,resveratrol,0.12 uM,24 h,9,249,258,3,0,0,0,NPC
decitabine_0.12uM_24h,decitabine,0.12 uM,24 h,9,249,258,3,32,22,10,NPC
regorafenib_0.12uM_24h,regorafenib,0.12 uM,24 h,9,192,201,3,1,0,1,NPC
belinostat_0.12uM_24h,belinostat,0.12 uM,24 h,9,249,258,3,315,147,168,NPC
azacitidine_0.12uM_24h,azacitidine,0.12 uM,24 h,9,249,258,3,17,6,11,NPC
alectinib_0.12uM_24h,alectinib,0.12 uM,24 h,9,192,201,3,2,1,1,NPC
vorinostat_0.12uM_24h,vorinostat,0.12 uM,24 h,9,249,258,3,17,13,4,NPC
tranylcypromine_0.12uM_24h,tranylcypromine,0.12 uM,24 h,9,249,258,3,0,0,0,NPC
tranylcypromine_0.37uM_24h,tranylcypromine,0.37 uM,24 h,9,249,258,3,0,0,0,NPC
ponatinib_0.37uM_24h,ponatinib,0.37 uM,24 h,9,192,201,3,301,124,177,NPC
dabrafenib_0.37uM_24h,dabrafenib,0.37 uM,24 h,9,192,201,3,114,41,73,NPC
azacitidine_0.37uM_24h,azacitidine,0.37 uM,24 h,9,249,258,3,42,24,18,NPC
regorafenib_0.37uM_24h,regorafenib,0.37 uM,24 h,9,192,201,3,20,8,12,NPC
decitabine_0.37uM_24h,decitabine,0.37 uM,24 h,9,249,258,3,59,39,20,NPC
alectinib_0.37uM_24h,alectinib,0.37 uM,24 h,9,192,201,3,1,1,0,NPC
belinostat_0.37uM_24h,belinostat,0.37 uM,24 h,9,249,258,3,367,170,197,NPC
decitabine_1.11uM_24h,decitabine,1.11 uM,24 h,9,249,258,3,75,35,40,NPC
alectinib_1.11uM_24h,alectinib,1.11 uM,24 h,9,192,201,3,1,1,0,NPC
vorinostat_1.11uM_6h,vorinostat,1.11 uM,6 h,9,4,13,2,141,85,56,NPC
belinostat_1.11uM_24h,belinostat,1.11 uM,24 h,9,249,258,3,496,265,231,NPC
tranylcypromine_1.11uM_24h,tranylcypromine,1.11 uM,24 h,9,249,258,3,2,1,1,NPC
regorafenib_1.11uM_24h,regorafenib,1.11 uM,24 h,9,192,201,3,38,13,25,NPC
ponatinib_1.11uM_24h,ponatinib,1.11 uM,24 h,9,192,201,3,308,131,177,NPC
azacitidine_1.11uM_24h,azacitidine,1.11 uM,24 h,9,249,258,3,48,32,16,NPC
dabrafenib_1.11uM_24h,dabrafenib,1.11 uM,24 h,9,192,201,3,110,54,56,NPC
belinostat_3.33uM_24h,belinostat,3.33 uM,24 h,9,249,258,3,580,297,283,NPC
ponatinib_3.33uM_24h,ponatinib,3.33 uM,24 h,9,192,201,3,546,209,337,NPC
dabrafenib_3.33uM_24h,dabrafenib,3.33 uM,24 h,9,192,201,3,158,75,83,NPC
tranylcypromine_3.33uM_24h,tranylcypromine,3.33 uM,24 h,9,249,258,3,2,2,0,NPC
decitabine_3.33uM_24h,decitabine,3.33 uM,24 h,9,249,258,3,91,67,24,NPC
regorafenib_3.33uM_24h,regorafenib,3.33 uM,24 h,9,192,201,3,47,18,29,NPC
azacitidine_3.33uM_24h,azacitidine,3.33 uM,24 h,9,249,258,3,94,39,55,NPC
alectinib_3.33uM_24h,alectinib,3.33 uM,24 h,9,192,201,3,5,2,3,NPC
methysergide_10uM_24h,methysergide,10 uM,24 h,8,50,58,2,49,17,32,NPC
paclitaxel_10uM_24h,paclitaxel,10 uM,24 h,8,50,58,2,326,115,211,NPC
clomifene_10uM_24h,clomifene,10 uM,24 h,8,50,58,2,3,0,3,NPC
cabergoline_10uM_24h,cabergoline,10 uM,24 h,8,45,53,2,1,1,0,NPC
digoxin_10uM_24h,digoxin,10 uM,24 h,8,25,33,1,648,265,383,NPC
bromocriptine_10uM_24h,bromocriptine,10 uM,24 h,8,45,53,2,34,15,19,NPC
aniracetam_10uM_24h,aniracetam,10 uM,24 h,8,49,57,3,21,6,15,NPC
glimepiride_10uM_24h,glimepiride,10 uM,24 h,8,50,58,2,8,1,7,NPC
nadolol_10uM_24h,nadolol,10 uM,24 h,8,50,58,2,4,1,3,NPC
clonidine_10uM_24h,clonidine,10 uM,24 h,8,56,64,3,0,0,0,NPC
mitoxantrone_10uM_24h,mitoxantrone,10 uM,24 h,8,183,191,5,781,284,497,NPC
cimetidine_10uM_24h,cimetidine,10 uM,24 h,8,50,58,2,48,22,26,NPC
vinpocetine_10uM_24h,vinpocetine,10 uM,24 h,8,25,33,1,0,0,0,NPC
pinacidil_10uM_24h,pinacidil,10 uM,24 h,8,45,53,2,8,2,6,NPC
flunarizine_10uM_24h,flunarizine,10 uM,24 h,8,45,53,2,295,104,191,NPC
quercetin_10uM_24h,quercetin,10 uM,24 h,8,56,64,3,60,17,43,NPC
flunisolide_10uM_24h,flunisolide,10 uM,24 h,8,50,58,2,17,1,16,NPC
ponatinib_0.04uM_24h,ponatinib,0.04 uM,24 h,8,171,179,3,267,117,150,NPC
ponatinib_0.12uM_24h,ponatinib,0.12 uM,24 h,8,171,179,3,153,66,87,NPC
dabrafenib_0.12uM_24h,dabrafenib,0.12 uM,24 h,8,170,178,3,52,30,22,NPC
naloxone_10uM_24h,naloxone,10 uM,24 h,7,33,40,2,0,0,0,NPC
etodolac_10uM_24h,etodolac,10 uM,24 h,7,37,44,2,0,0,0,NPC
ouabain_10uM_24h,ouabain,10 uM,24 h,7,42,49,3,631,284,347,NPC
potassium-canrenoate_10uM_24h,potassium-canrenoate,10 uM,24 h,7,28,35,2,1,1,0,NPC
idelalisib_10uM_24h,idelalisib,10 uM,24 h,7,151,158,3,37,18,19,NPC
tacrolimus_10uM_24h,tacrolimus,10 uM,24 h,7,42,49,2,201,72,129,NPC
estriol_10uM_24h,estriol,10 uM,24 h,7,33,40,2,32,11,21,NPC
carbenoxolone_10uM_24h,carbenoxolone,10 uM,24 h,7,33,40,2,10,4,6,NPC
vandetanib_10uM_24h,vandetanib,10 uM,24 h,7,151,158,3,730,297,433,NPC
betamethasone_10uM_24h,betamethasone,10 uM,24 h,7,33,40,2,0,0,0,NPC
medrysone_10uM_24h,medrysone,10 uM,24 h,7,33,40,2,2,0,2,NPC
noretynodrel_10uM_24h,noretynodrel,10 uM,24 h,7,28,35,2,197,75,122,NPC
finasteride_10uM_24h,finasteride,10 uM,24 h,7,33,40,2,1,1,0,NPC
rutin_10uM_24h,rutin,10 uM,24 h,7,33,40,2,1,0,1,NPC
ibrutinib_10uM_24h,ibrutinib,10 uM,24 h,7,151,158,3,151,65,86,NPC
biperiden_10uM_24h,biperiden,10 uM,24 h,7,25,32,1,5,1,4,NPC
tivozanib_10uM_24h,tivozanib,10 uM,24 h,7,151,158,3,434,172,262,NPC
dacomitinib_0.04uM_24h,dacomitinib,0.04 uM,24 h,7,151,158,3,4,1,3,NPC
ibrutinib_0.04uM_24h,ibrutinib,0.04 uM,24 h,7,151,158,3,3,1,2,NPC
masitinib_0.04uM_24h,masitinib,0.04 uM,24 h,7,151,158,3,2,2,0,NPC
everolimus_0.04uM_24h,everolimus,0.04 uM,24 h,7,151,158,3,358,137,221,NPC
idelalisib_0.04uM_24h,idelalisib,0.04 uM,24 h,7,151,158,3,22,11,11,NPC
sunitinib_0.04uM_24h,sunitinib,0.04 uM,24 h,7,151,158,3,33,12,21,NPC
pazopanib_0.04uM_24h,pazopanib,0.04 uM,24 h,7,151,158,3,0,0,0,NPC
cabozantinib_0.04uM_24h,cabozantinib,0.04 uM,24 h,7,151,158,3,95,14,81,NPC
tivozanib_0.04uM_24h,tivozanib,0.04 uM,24 h,7,151,158,3,17,10,7,NPC
bosutinib_0.04uM_24h,bosutinib,0.04 uM,24 h,7,151,158,3,375,136,239,NPC
everolimus_0.12uM_24h,everolimus,0.12 uM,24 h,7,151,158,3,202,94,108,NPC
vandetanib_0.12uM_24h,vandetanib,0.12 uM,24 h,7,151,158,3,6,3,3,NPC
sunitinib_0.12uM_24h,sunitinib,0.12 uM,24 h,7,151,158,3,58,17,41,NPC
dacomitinib_0.12uM_24h,dacomitinib,0.12 uM,24 h,7,151,158,3,3,2,1,NPC
bosutinib_0.12uM_24h,bosutinib,0.12 uM,24 h,7,151,158,3,122,64,58,NPC
idelalisib_0.12uM_24h,idelalisib,0.12 uM,24 h,7,151,158,3,21,9,12,NPC
ibrutinib_0.12uM_24h,ibrutinib,0.12 uM,24 h,7,151,158,3,14,8,6,NPC
cabozantinib_0.12uM_24h,cabozantinib,0.12 uM,24 h,7,151,158,3,7,5,2,NPC
tivozanib_0.12uM_24h,tivozanib,0.12 uM,24 h,7,151,158,3,1,1,0,NPC
pazopanib_0.12uM_24h,pazopanib,0.12 uM,24 h,7,151,158,3,18,7,11,NPC
tivozanib_0.37uM_24h,tivozanib,0.37 uM,24 h,7,151,158,3,3,1,2,NPC
idelalisib_0.37uM_24h,idelalisib,0.37 uM,24 h,7,151,158,3,33,21,12,NPC
masitinib_0.37uM_24h,masitinib,0.37 uM,24 h,7,151,158,3,0,0,0,NPC
ibrutinib_0.37uM_24h,ibrutinib,0.37 uM,24 h,7,151,158,3,15,2,13,NPC
cabozantinib_0.37uM_24h,cabozantinib,0.37 uM,24 h,7,151,158,3,6,1,5,NPC
dacomitinib_0.37uM_24h,dacomitinib,0.37 uM,24 h,7,151,158,3,5,2,3,NPC
bosutinib_0.37uM_24h,bosutinib,0.37 uM,24 h,7,151,158,3,179,72,107,NPC
everolimus_0.37uM_24h,everolimus,0.37 uM,24 h,7,151,158,3,172,68,104,NPC
sunitinib_0.37uM_24h,sunitinib,0.37 uM,24 h,7,151,158,3,25,22,3,NPC
pazopanib_0.37uM_24h,pazopanib,0.37 uM,24 h,7,151,158,3,11,3,8,NPC
sunitinib_1.11uM_24h,sunitinib,1.11 uM,24 h,7,151,158,3,68,36,32,NPC
pazopanib_1.11uM_24h,pazopanib,1.11 uM,24 h,7,151,158,3,61,25,36,NPC
cabozantinib_1.11uM_24h,cabozantinib,1.11 uM,24 h,7,151,158,3,8,4,4,NPC
idelalisib_1.11uM_24h,idelalisib,1.11 uM,24 h,7,151,158,3,243,111,132,NPC
vandetanib_1.11uM_24h,vandetanib,1.11 uM,24 h,7,151,158,3,4,2,2,NPC
everolimus_1.11uM_24h,everolimus,1.11 uM,24 h,7,151,158,3,155,60,95,NPC
bosutinib_1.11uM_24h,bosutinib,1.11 uM,24 h,7,151,158,3,169,72,97,NPC
ibrutinib_1.11uM_24h,ibrutinib,1.11 uM,24 h,7,151,158,3,16,6,10,NPC
dacomitinib_1.11uM_24h,dacomitinib,1.11 uM,24 h,7,151,158,3,2,1,1,NPC
masitinib_1.11uM_24h,masitinib,1.11 uM,24 h,7,151,158,3,14,6,8,NPC
tivozanib_1.11uM_24h,tivozanib,1.11 uM,24 h,7,151,158,3,15,4,11,NPC
vandetanib_3.33uM_24h,vandetanib,3.33 uM,24 h,7,151,158,3,28,17,11,NPC
pazopanib_3.33uM_24h,pazopanib,3.33 uM,24 h,7,151,158,3,34,13,21,NPC
idelalisib_3.33uM_24h,idelalisib,3.33 uM,24 h,7,151,158,3,8,5,3,NPC
ibrutinib_3.33uM_24h,ibrutinib,3.33 uM,24 h,7,151,158,3,64,10,54,NPC
everolimus_3.33uM_24h,everolimus,3.33 uM,24 h,7,151,158,3,216,85,131,NPC
dacomitinib_3.33uM_24h,dacomitinib,3.33 uM,24 h,7,151,158,3,49,28,21,NPC
cabozantinib_3.33uM_24h,cabozantinib,3.33 uM,24 h,7,151,158,3,12,4,8,NPC
sunitinib_3.33uM_24h,sunitinib,3.33 uM,24 h,7,151,158,3,125,52,73,NPC
tivozanib_3.33uM_24h,tivozanib,3.33 uM,24 h,7,151,158,3,47,16,31,NPC
bosutinib_3.33uM_24h,bosutinib,3.33 uM,24 h,7,151,158,3,302,120,182,NPC
masitinib_3.33uM_24h,masitinib,3.33 uM,24 h,7,151,158,3,6,1,5,NPC
icosapent_10uM_6h,icosapent,10 uM,6 h,6,30,36,2,93,20,73,NPC
temozolomide_10uM_24h,temozolomide,10 uM,24 h,6,54,60,2,10,0,10,NPC
fluspirilene_10uM_6h,fluspirilene,10 uM,6 h,6,30,36,2,84,30,54,NPC
adapalene_10uM_6h,adapalene,10 uM,6 h,6,30,36,2,107,36,71,NPC
quercetin_10uM_6h,quercetin,10 uM,6 h,6,30,36,2,55,11,44,NPC
imiquimod_10uM_24h,imiquimod,10 uM,24 h,6,54,60,2,0,0,0,NPC
clonidine_10uM_6h,clonidine,10 uM,6 h,6,30,36,2,2,2,0,NPC
etoposide_10uM_6h,etoposide,10 uM,6 h,6,30,36,2,77,32,45,NPC
estrone_10uM_6h,estrone,10 uM,6 h,6,30,36,2,67,28,39,NPC
tolazamide_10uM_6h,tolazamide,10 uM,6 h,6,30,36,2,1,0,1,NPC
lapatinib_10uM_24h,lapatinib,10 uM,24 h,6,26,32,2,0,0,0,NPC
hydroxychloroquine_10uM_24h,hydroxychloroquine,10 uM,24 h,6,54,60,2,10,3,7,NPC
gemfibrozil_10uM_6h,gemfibrozil,10 uM,6 h,6,30,36,2,185,66,119,NPC
thalidomide_10uM_6h,thalidomide,10 uM,6 h,6,30,36,2,53,22,31,NPC
glucosamine_10uM_6h,glucosamine,10 uM,6 h,6,30,36,2,0,0,0,NPC
caffeine_10uM_6h,caffeine,10 uM,6 h,6,30,36,2,0,0,0,NPC
progesterone_10uM_6h,progesterone,10 uM,6 h,6,30,36,2,30,9,21,NPC
carvedilol_10uM_24h,carvedilol,10 uM,24 h,6,65,71,2,184,74,110,NPC
imiquimod_10uM_6h,imiquimod,10 uM,6 h,6,30,36,2,0,0,0,NPC
capsaicin_10uM_24h,capsaicin,10 uM,24 h,6,54,60,2,74,15,59,NPC
diclofenac_10uM_6h,diclofenac,10 uM,6 h,6,30,36,2,23,7,16,NPC
vinblastine_10uM_24h,vinblastine,10 uM,24 h,6,35,41,2,490,217,273,NPC
vincristine_10uM_24h,vincristine,10 uM,24 h,6,35,41,2,546,237,309,NPC
pyrvinium-pamoate_10uM_6h,pyrvinium-pamoate,10 uM,6 h,6,30,36,2,359,101,258,NPC
bezafibrate_10uM_6h,bezafibrate,10 uM,6 h,6,30,36,2,2,1,1,NPC
ruxolitinib_10uM_24h,ruxolitinib,10 uM,24 h,6,17,23,1,0,0,0,NPC
hexachlorophene_10uM_6h,hexachlorophene,10 uM,6 h,6,30,36,2,108,40,68,NPC
epirubicin_10uM_6h,epirubicin,10 uM,6 h,6,30,36,2,426,160,266,NPC
adapalene_10uM_24h,adapalene,10 uM,24 h,6,54,60,2,87,26,61,NPC
etoposide_10uM_24h,etoposide,10 uM,24 h,6,54,60,2,448,175,273,NPC
verapamil_10uM_6h,verapamil,10 uM,6 h,6,30,36,2,7,4,3,NPC
chloroquine_10uM_6h,chloroquine,10 uM,6 h,6,30,36,2,1,1,0,NPC
isotretinoin_10uM_6h,isotretinoin,10 uM,6 h,6,30,36,2,10,4,6,NPC
vinorelbine_10uM_24h,vinorelbine,10 uM,24 h,6,17,23,1,377,159,218,NPC
temozolomide_10uM_6h,temozolomide,10 uM,6 h,6,30,36,2,3,1,2,NPC
pioglitazone_10uM_6h,pioglitazone,10 uM,6 h,6,30,36,2,0,0,0,NPC
quinidine_10uM_6h,quinidine,10 uM,6 h,6,30,36,2,1,0,1,NPC
tubocurarine_10uM_24h,tubocurarine,10 uM,24 h,6,29,35,2,6,2,4,NPC
icosapent_10uM_24h,icosapent,10 uM,24 h,6,54,60,2,2,2,0,NPC
nicotinamide_10uM_6h,nicotinamide,10 uM,6 h,6,30,36,2,72,23,49,NPC
cabozantinib_10uM_24h,cabozantinib,10 uM,24 h,6,129,135,3,170,54,116,NPC
cortisone_10uM_6h,cortisone,10 uM,6 h,6,30,36,2,198,59,139,NPC
gefitinib_10uM_24h,gefitinib,10 uM,24 h,6,17,23,1,0,0,0,NPC
calcifediol_10uM_6h,calcifediol,10 uM,6 h,6,30,36,2,17,10,7,NPC
hydroxychloroquine_10uM_6h,hydroxychloroquine,10 uM,6 h,6,30,36,2,36,17,19,NPC
acitretin_10uM_6h,acitretin,10 uM,6 h,6,30,36,2,12,3,9,NPC
sorafenib_10uM_6h,sorafenib,10 uM,6 h,6,30,36,2,208,49,159,NPC
gemfibrozil_10uM_24h,gemfibrozil,10 uM,24 h,6,54,60,2,0,0,0,NPC
metformin_10uM_6h,metformin,10 uM,6 h,6,30,36,2,6,1,5,NPC
mestranol_10uM_24h,mestranol,10 uM,24 h,6,8,14,1,0,0,0,NPC
clofibric-acid_10uM_6h,clofibric-acid,10 uM,6 h,6,30,36,2,10,5,5,NPC
mifepristone_10uM_6h,mifepristone,10 uM,6 h,6,30,36,2,75,18,57,NPC
phenylbutyrate_10uM_24h,phenylbutyrate,10 uM,24 h,6,54,60,2,6,4,2,NPC
nicotinamide_10uM_24h,nicotinamide,10 uM,24 h,6,54,60,2,0,0,0,NPC
nizatidine_10uM_24h,nizatidine,10 uM,24 h,6,31,37,2,0,0,0,NPC
cortisone_10uM_24h,cortisone,10 uM,24 h,6,54,60,2,2,0,2,NPC
celecoxib_10uM_6h,celecoxib,10 uM,6 h,6,30,36,2,29,16,13,NPC
nitrendipine_10uM_6h,nitrendipine,10 uM,6 h,6,30,36,2,0,0,0,NPC
nimodipine_10uM_6h,nimodipine,10 uM,6 h,6,30,36,2,26,9,17,NPC
phenylbutyrate_10uM_6h,phenylbutyrate,10 uM,6 h,6,30,36,2,0,0,0,NPC
valsartan_10uM_24h,valsartan,10 uM,24 h,6,65,71,2,7,2,5,NPC
carbamazepine_10uM_6h,carbamazepine,10 uM,6 h,6,30,36,2,27,6,21,NPC
acarbose_10uM_24h,acarbose,10 uM,24 h,6,8,14,1,1,1,0,NPC
capsaicin_10uM_6h,capsaicin,10 uM,6 h,6,30,36,2,166,54,112,NPC
rilmenidine_10uM_6h,rilmenidine,10 uM,6 h,6,30,36,2,0,0,0,NPC
minoxidil_10uM_6h,minoxidil,10 uM,6 h,6,30,36,2,1,1,0,NPC
loperamide_10uM_6h,loperamide,10 uM,6 h,6,30,36,2,14,9,5,NPC
hexachlorophene_10uM_24h,hexachlorophene,10 uM,24 h,6,54,60,2,81,43,38,NPC
trifluoperazine_10uM_24h,trifluoperazine,10 uM,24 h,6,54,60,2,147,53,94,NPC
calcitriol_10uM_6h,calcitriol,10 uM,6 h,6,30,36,2,62,29,33,NPC
cholic-acid_10uM_6h,cholic-acid,10 uM,6 h,6,30,36,2,0,0,0,NPC
amiodarone_10uM_24h,amiodarone,10 uM,24 h,6,45,51,2,505,151,354,NPC
estradiol_10uM_6h,estradiol,10 uM,6 h,6,30,36,2,151,47,104,NPC
metformin_10uM_24h,metformin,10 uM,24 h,6,54,60,2,1,0,1,NPC
sirolimus_10uM_6h,sirolimus,10 uM,6 h,6,30,36,2,297,98,199,NPC
glucosamine_10uM_24h,glucosamine,10 uM,24 h,6,54,60,2,0,0,0,NPC
noscapine_10uM_24h,noscapine,10 uM,24 h,6,28,34,2,0,0,0,NPC
vandetanib_0.04uM_24h,vandetanib,0.04 uM,24 h,6,129,135,3,12,9,3,NPC
masitinib_0.12uM_24h,masitinib,0.12 uM,24 h,6,131,137,3,9,7,2,NPC
vandetanib_0.37uM_24h,vandetanib,0.37 uM,24 h,6,129,135,3,94,55,39,NPC
fulvestrant_0.37uM_24h,fulvestrant,0.37 uM,24 h,6,91,97,2,2,2,0,NPC
fulvestrant_1.11uM_24h,fulvestrant,1.11 uM,24 h,6,91,97,2,11,3,8,NPC
fulvestrant_3.33uM_24h,fulvestrant,3.33 uM,24 h,6,91,97,2,26,15,11,NPC
simvastatin_10uM_6h,simvastatin,10 uM,6 h,5,39,44,2,9,3,6,NPC
pravastatin_10uM_6h,pravastatin,10 uM,6 h,5,39,44,2,0,0,0,NPC
carbidopa_10uM_6h,carbidopa,10 uM,6 h,5,39,44,2,0,0,0,NPC
ephedrine_10uM_6h,ephedrine,10 uM,6 h,5,39,44,2,0,0,0,NPC
suramin_10uM_24h,suramin,10 uM,24 h,5,41,46,2,60,22,38,NPC
trifluridine_10uM_6h,trifluridine,10 uM,6 h,5,39,44,2,1,1,0,NPC
isradipine_10uM_24h,isradipine,10 uM,24 h,5,41,46,2,91,35,56,NPC
risperidone_10uM_6h,risperidone,10 uM,6 h,5,39,44,2,26,13,13,NPC
fluoxetine_10uM_6h,fluoxetine,10 uM,6 h,5,39,44,2,4,2,2,NPC
ipratropium_10uM_24h,ipratropium,10 uM,24 h,5,26,31,2,268,99,169,NPC
lovastatin_10uM_6h,lovastatin,10 uM,6 h,5,39,44,2,1,1,0,NPC
carbidopa_10uM_24h,carbidopa,10 uM,24 h,5,41,46,2,0,0,0,NPC
reboxetine_10uM_6h,reboxetine,10 uM,6 h,5,39,44,2,5,1,4,NPC
clopidogrel_10uM_6h,clopidogrel,10 uM,6 h,5,39,44,2,1,0,1,NPC
atorvastatin_10uM_6h,atorvastatin,10 uM,6 h,5,39,44,2,1,1,0,NPC
fluoxetine_10uM_24h,fluoxetine,10 uM,24 h,5,41,46,2,6,4,2,NPC
suramin_10uM_6h,suramin,10 uM,6 h,5,39,44,2,192,67,125,NPC
isradipine_10uM_6h,isradipine,10 uM,6 h,5,39,44,2,0,0,0,NPC
yohimbine_10uM_24h,yohimbine,10 uM,24 h,5,26,31,2,0,0,0,NPC
sunitinib_10uM_24h,sunitinib,10 uM,24 h,5,61,66,2,610,247,363,NPC
trifluridine_10uM_24h,trifluridine,10 uM,24 h,5,41,46,2,17,7,10,NPC
atorvastatin_10uM_24h,atorvastatin,10 uM,24 h,5,41,46,2,40,11,29,NPC
cerulenin_10uM_6h,cerulenin,10 uM,6 h,5,39,44,2,1,0,1,NPC
cerulenin_10uM_24h,cerulenin,10 uM,24 h,5,41,46,2,1,1,0,NPC
trifluoperazine_10uM_6h,trifluoperazine,10 uM,6 h,5,26,31,2,345,91,254,NPC
ephedrine_10uM_24h,ephedrine,10 uM,24 h,5,41,46,2,0,0,0,NPC
clopidogrel_10uM_24h,clopidogrel,10 uM,24 h,5,41,46,2,0,0,0,NPC
clozapine_10uM_6h,clozapine,10 uM,6 h,5,39,44,2,5,2,3,NPC
fluvastatin_10uM_6h,fluvastatin,10 uM,6 h,5,39,44,2,1,1,0,NPC
spiperone_10uM_6h,spiperone,10 uM,6 h,5,39,44,2,9,7,2,NPC
oxibendazole_10uM_24h,oxibendazole,10 uM,24 h,4,25,29,1,96,47,49,NPC
alprenolol_10uM_24h,alprenolol,10 uM,24 h,4,20,24,1,0,0,0,NPC
irinotecan_10uM_24h,irinotecan,10 uM,24 h,4,20,24,1,270,110,160,NPC
primaquine_10uM_24h,primaquine,10 uM,24 h,4,25,29,1,11,1,10,NPC
betaxolol_10uM_24h,betaxolol,10 uM,24 h,4,25,29,1,1,1,0,NPC
donepezil_10uM_24h,donepezil,10 uM,24 h,4,25,29,1,6,2,4,NPC
bumetanide_10uM_24h,bumetanide,10 uM,24 h,4,25,29,1,5,2,3,NPC
probenecid_10uM_24h,probenecid,10 uM,24 h,4,25,29,1,5,1,4,NPC
altrenogest_10uM_24h,altrenogest,10 uM,24 h,4,25,29,1,32,4,28,NPC
olmesartan-medoxomil_10uM_24h,olmesartan-medoxomil,10 uM,24 h,4,25,29,1,113,44,69,NPC
mitotane_10uM_24h,mitotane,10 uM,24 h,4,25,29,1,75,25,50,NPC
erythromycin-estolate_10uM_24h,erythromycin-estolate,10 uM,24 h,4,20,24,1,88,30,58,NPC
terguride_10uM_24h,terguride,10 uM,24 h,4,25,29,1,0,0,0,NPC
perphenazine_10uM_24h,perphenazine,10 uM,24 h,4,25,29,1,301,103,198,NPC
amiodarone_10uM_6h,amiodarone,10 uM,6 h,4,18,22,2,230,54,176,NPC
prednisone_10uM_24h,prednisone,10 uM,24 h,4,25,29,1,7,1,6,NPC
flutamide_10uM_24h,flutamide,10 uM,24 h,4,20,24,1,15,10,5,NPC
altretamine_10uM_24h,altretamine,10 uM,24 h,4,20,24,1,16,6,10,NPC
saquinavir_10uM_24h,saquinavir,10 uM,24 h,4,25,29,1,19,10,9,NPC
rosuvastatin_10uM_24h,rosuvastatin,10 uM,24 h,4,25,29,1,39,18,21,NPC
vardenafil_10uM_24h,vardenafil,10 uM,24 h,4,25,29,1,7,1,6,NPC
bifemelane_10uM_24h,bifemelane,10 uM,24 h,4,20,24,1,76,32,44,NPC
pipamperone_10uM_24h,pipamperone,10 uM,24 h,4,25,29,1,15,2,13,NPC
toltrazuril_10uM_24h,toltrazuril,10 uM,24 h,4,25,29,1,34,8,26,NPC
levocabastine_10uM_24h,levocabastine,10 uM,24 h,4,20,24,1,222,124,98,NPC
pirenzepine_10uM_24h,pirenzepine,10 uM,24 h,4,25,29,1,0,0,0,NPC
escitalopram_10uM_24h,escitalopram,10 uM,24 h,4,25,29,1,22,9,13,NPC
mycophenolate-mofetil_10uM_24h,mycophenolate-mofetil,10 uM,24 h,4,25,29,1,38,10,28,NPC
primidone_10uM_24h,primidone,10 uM,24 h,4,25,29,1,15,2,13,NPC
flupentixol_10uM_24h,flupentixol,10 uM,24 h,4,20,24,1,333,110,223,NPC
flucloxacillin_10uM_24h,flucloxacillin,10 uM,24 h,4,25,29,1,7,0,7,NPC
ambroxol_10uM_24h,ambroxol,10 uM,24 h,4,25,29,1,0,0,0,NPC
nifurtimox_10uM_24h,nifurtimox,10 uM,24 h,4,25,29,1,0,0,0,NPC
ioxaglic-acid_10uM_24h,ioxaglic-acid,10 uM,24 h,4,25,29,1,8,2,6,NPC
meloxicam_10uM_24h,meloxicam,10 uM,24 h,4,25,29,1,59,7,52,NPC
hydralazine_10uM_24h,hydralazine,10 uM,24 h,4,20,24,1,1,1,0,NPC
mexiletine_10uM_24h,mexiletine,10 uM,24 h,4,25,29,1,0,0,0,NPC
alprostadil_10uM_24h,alprostadil,10 uM,24 h,4,25,29,1,265,97,168,NPC
clemastine_10uM_24h,clemastine,10 uM,24 h,4,25,29,1,20,6,14,NPC
bromhexine_10uM_24h,bromhexine,10 uM,24 h,4,20,24,1,102,64,38,NPC
tripelennamine_10uM_24h,tripelennamine,10 uM,24 h,4,25,29,1,2,0,2,NPC
fluvoxamine_10uM_24h,fluvoxamine,10 uM,24 h,4,20,24,1,77,44,33,NPC
mephentermine_10uM_24h,mephentermine,10 uM,24 h,4,25,29,1,1,0,1,NPC
dexamethasone-acetate_10uM_24h,dexamethasone-acetate,10 uM,24 h,4,25,29,1,6,3,3,NPC
amoxapine_10uM_24h,amoxapine,10 uM,24 h,4,25,29,1,0,0,0,NPC
nateglinide_10uM_24h,nateglinide,10 uM,24 h,4,25,29,1,0,0,0,NPC
lisuride_10uM_24h,lisuride,10 uM,24 h,4,20,24,1,69,40,29,NPC
flecainide_10uM_24h,flecainide,10 uM,24 h,4,25,29,1,11,7,4,NPC
cetirizine_10uM_24h,cetirizine,10 uM,24 h,4,25,29,1,1,0,1,NPC
benzthiazide_10uM_24h,benzthiazide,10 uM,24 h,4,25,29,1,23,6,17,NPC
hydroquinidine_10uM_24h,hydroquinidine,10 uM,24 h,4,25,29,1,0,0,0,NPC
cyclopentolate_10uM_24h,cyclopentolate,10 uM,24 h,4,25,29,1,0,0,0,NPC
isocarboxazid_10uM_24h,isocarboxazid,10 uM,24 h,4,20,24,1,32,16,16,NPC
moxonidine_10uM_24h,moxonidine,10 uM,24 h,4,20,24,1,18,15,3,NPC
ceforanide_10uM_24h,ceforanide,10 uM,24 h,4,20,24,1,23,15,8,NPC
fenbufen_10uM_24h,fenbufen,10 uM,24 h,4,20,24,1,0,0,0,NPC
mianserin_10uM_24h,mianserin,10 uM,24 h,4,20,24,1,160,77,83,NPC
diloxanide_10uM_24h,diloxanide,10 uM,24 h,4,25,29,1,0,0,0,NPC
prednicarbate_10uM_24h,prednicarbate,10 uM,24 h,4,25,29,1,179,54,125,NPC
triflupromazine_10uM_24h,triflupromazine,10 uM,24 h,4,20,24,1,109,55,54,NPC
moexipril_10uM_24h,moexipril,10 uM,24 h,4,25,29,1,1,1,0,NPC
cilnidipine_10uM_24h,cilnidipine,10 uM,24 h,4,25,29,1,10,4,6,NPC
hydrocortisone_10uM_24h,hydrocortisone,10 uM,24 h,4,25,29,1,24,5,19,NPC
chloroxine_10uM_24h,chloroxine,10 uM,24 h,4,20,24,1,22,11,11,NPC
labetalol_10uM_24h,labetalol,10 uM,24 h,4,25,29,1,1,0,1,NPC
amitriptyline_10uM_24h,amitriptyline,10 uM,24 h,4,25,29,1,2,1,1,NPC
eplerenone_10uM_24h,eplerenone,10 uM,24 h,4,25,29,1,86,24,62,NPC
amcinonide_10uM_24h,amcinonide,10 uM,24 h,4,25,29,1,0,0,0,NPC
loxapine_10uM_24h,loxapine,10 uM,24 h,4,20,24,1,51,18,33,NPC
fluticasone-propionate_10uM_24h,fluticasone-propionate,10 uM,24 h,4,25,29,1,0,0,0,NPC
bucladesine_10uM_24h,bucladesine,10 uM,24 h,4,25,29,1,4,2,2,NPC
pirfenidone_10uM_24h,pirfenidone,10 uM,24 h,4,20,24,1,113,51,62,NPC
benzydamine_10uM_24h,benzydamine,10 uM,24 h,4,25,29,1,0,0,0,NPC
sertaconazole_10uM_24h,sertaconazole,10 uM,24 h,4,25,29,1,188,53,135,NPC
proxymetacaine_10uM_24h,proxymetacaine,10 uM,24 h,4,20,24,1,102,36,66,NPC
azasetron_10uM_24h,azasetron,10 uM,24 h,4,25,29,1,3,1,2,NPC
methantheline_10uM_24h,methantheline,10 uM,24 h,4,25,29,1,2,0,2,NPC
nefopam_10uM_24h,nefopam,10 uM,24 h,4,25,29,1,88,18,70,NPC
trazodone_10uM_24h,trazodone,10 uM,24 h,4,20,24,1,0,0,0,NPC
enalapril_10uM_24h,enalapril,10 uM,24 h,4,25,29,1,20,3,17,NPC
isoxsuprine_10uM_24h,isoxsuprine,10 uM,24 h,4,25,29,1,1,0,1,NPC
formoterol_10uM_24h,formoterol,10 uM,24 h,4,20,24,1,178,78,100,NPC
betahistine_10uM_24h,betahistine,10 uM,24 h,4,25,29,1,0,0,0,NPC
ketoprofen_10uM_24h,ketoprofen,10 uM,24 h,4,25,29,1,15,2,13,NPC
bisoprolol_10uM_24h,bisoprolol,10 uM,24 h,4,25,29,1,53,16,37,NPC
midostaurin_10uM_24h,midostaurin,10 uM,24 h,4,25,29,1,466,164,302,NPC
clomethiazole_10uM_24h,clomethiazole,10 uM,24 h,4,25,29,1,335,121,214,NPC
bisacodyl_10uM_24h,bisacodyl,10 uM,24 h,4,25,29,1,1,0,1,NPC
nimesulide_10uM_24h,nimesulide,10 uM,24 h,4,20,24,1,93,33,60,NPC
tropisetron_10uM_24h,tropisetron,10 uM,24 h,4,20,24,1,0,0,0,NPC
trapidil_10uM_24h,trapidil,10 uM,24 h,4,20,24,1,3,2,1,NPC
ketotifen_10uM_24h,ketotifen,10 uM,24 h,4,25,29,1,7,0,7,NPC
gliquidone_10uM_24h,gliquidone,10 uM,24 h,4,20,24,1,10,7,3,NPC
oxaprozin_10uM_24h,oxaprozin,10 uM,24 h,4,25,29,1,0,0,0,NPC
riboflavin_10uM_24h,riboflavin,10 uM,24 h,4,20,24,1,84,47,37,NPC
naftidrofuryl_10uM_24h,naftidrofuryl,10 uM,24 h,4,25,29,1,0,0,0,NPC
piretanide_10uM_24h,piretanide,10 uM,24 h,4,20,24,1,66,26,40,NPC
desipramine_10uM_24h,desipramine,10 uM,24 h,4,25,29,1,81,21,60,NPC
tiabendazole_10uM_24h,tiabendazole,10 uM,24 h,4,25,29,1,407,155,252,NPC
mebeverine_10uM_24h,mebeverine,10 uM,24 h,4,20,24,1,1,1,0,NPC
butoconazole_10uM_24h,butoconazole,10 uM,24 h,4,25,29,1,17,11,6,NPC
diethylcarbamazine_10uM_24h,diethylcarbamazine,10 uM,24 h,4,25,29,1,2,0,2,NPC
pivmecillinam_10uM_24h,pivmecillinam,10 uM,24 h,4,20,24,1,196,74,122,NPC
brompheniramine_10uM_24h,brompheniramine,10 uM,24 h,4,25,29,1,0,0,0,NPC
lidoflazine_10uM_24h,lidoflazine,10 uM,24 h,4,20,24,1,28,19,9,NPC
alverine_10uM_24h,alverine,10 uM,24 h,4,25,29,1,0,0,0,NPC
diclofenamide_10uM_24h,diclofenamide,10 uM,24 h,4,25,29,1,409,153,256,NPC
carteolol_10uM_24h,carteolol,10 uM,24 h,4,25,29,1,28,7,21,NPC
enrofloxacin_10uM_24h,enrofloxacin,10 uM,24 h,4,25,29,1,0,0,0,NPC
lonidamine_10uM_24h,lonidamine,10 uM,24 h,4,20,24,1,1,1,0,NPC
dienestrol_10uM_24h,dienestrol,10 uM,24 h,4,25,29,1,0,0,0,NPC
dipyridamole_10uM_24h,dipyridamole,10 uM,24 h,4,25,29,1,0,0,0,NPC
deracoxib_10uM_24h,deracoxib,10 uM,24 h,4,25,29,1,3,0,3,NPC
nonoxynol-9_10uM_24h,nonoxynol-9,10 uM,24 h,4,25,29,1,111,42,69,NPC
perindopril_10uM_24h,perindopril,10 uM,24 h,4,25,29,1,0,0,0,NPC
physostigmine_10uM_24h,physostigmine,10 uM,24 h,4,25,29,1,9,4,5,NPC
quetiapine_10uM_24h,quetiapine,10 uM,24 h,4,25,29,1,119,20,99,NPC
meptazinol_10uM_24h,meptazinol,10 uM,24 h,4,25,29,1,1,0,1,NPC
phenoxybenzamine_10uM_24h,phenoxybenzamine,10 uM,24 h,4,25,29,1,71,26,45,NPC
amperozide_10uM_24h,amperozide,10 uM,24 h,4,25,29,1,2,1,1,NPC
cilostazol_10uM_24h,cilostazol,10 uM,24 h,4,25,29,1,2,0,2,NPC
naltrexone_10uM_24h,naltrexone,10 uM,24 h,4,25,29,1,12,4,8,NPC
lidocaine_10uM_24h,lidocaine,10 uM,24 h,4,25,29,1,0,0,0,NPC
thiothixene_10uM_24h,thiothixene,10 uM,24 h,4,25,29,1,15,9,6,NPC
aniracetam_10uM_6h,aniracetam,10 uM,6 h,4,32,36,2,0,0,0,NPC
erythromycin_10uM_24h,erythromycin,10 uM,24 h,4,25,29,1,0,0,0,NPC
betamethasone-acetate_10uM_24h,betamethasone-acetate,10 uM,24 h,4,25,29,1,12,0,12,NPC
crotamiton_10uM_24h,crotamiton,10 uM,24 h,4,25,29,1,0,0,0,NPC
carprofen_10uM_24h,carprofen,10 uM,24 h,4,25,29,1,0,0,0,NPC
trioxsalen_10uM_24h,trioxsalen,10 uM,24 h,4,25,29,1,0,0,0,NPC
raloxifene_10uM_24h,raloxifene,10 uM,24 h,4,25,29,1,3,0,3,NPC
proguanil_10uM_24h,proguanil,10 uM,24 h,4,25,29,1,2,0,2,NPC
piperacetazine_10uM_24h,piperacetazine,10 uM,24 h,4,25,29,1,0,0,0,NPC
tenoxicam_10uM_24h,tenoxicam,10 uM,24 h,4,20,24,1,2,2,0,NPC
aminoglutethimide_10uM_24h,aminoglutethimide,10 uM,24 h,4,25,29,1,0,0,0,NPC
oxantel_10uM_24h,oxantel,10 uM,24 h,4,25,29,1,0,0,0,NPC
reserpine_10uM_24h,reserpine,10 uM,24 h,4,25,29,1,5,1,4,NPC
raclopride_10uM_24h,raclopride,10 uM,24 h,4,20,24,1,188,84,104,NPC
zolmitriptan_10uM_24h,zolmitriptan,10 uM,24 h,4,25,29,1,7,1,6,NPC
irsogladine_10uM_24h,irsogladine,10 uM,24 h,4,25,29,1,53,17,36,NPC
econazole_10uM_24h,econazole,10 uM,24 h,4,25,29,1,226,80,146,NPC
thiotepa_10uM_24h,thiotepa,10 uM,24 h,4,25,29,1,5,3,2,NPC
cefixime_10uM_24h,cefixime,10 uM,24 h,4,20,24,1,4,4,0,NPC
propafenone_10uM_24h,propafenone,10 uM,24 h,4,25,29,1,1,0,1,NPC
naftifine_10uM_24h,naftifine,10 uM,24 h,4,25,29,1,53,18,35,NPC
rimexolone_10uM_24h,rimexolone,10 uM,24 h,4,20,24,1,1,0,1,NPC
pyrimethamine_10uM_24h,pyrimethamine,10 uM,24 h,4,25,29,1,3,1,2,NPC
flumazenil_10uM_24h,flumazenil,10 uM,24 h,4,25,29,1,62,12,50,NPC
ezetimibe_10uM_24h,ezetimibe,10 uM,24 h,4,25,29,1,162,57,105,NPC
dosulepin_10uM_24h,dosulepin,10 uM,24 h,4,25,29,1,1,1,0,NPC
clofibrate_10uM_24h,clofibrate,10 uM,24 h,4,25,29,1,0,0,0,NPC
naproxen_10uM_24h,naproxen,10 uM,24 h,4,25,29,1,0,0,0,NPC
dydrogesterone_10uM_24h,dydrogesterone,10 uM,24 h,4,25,29,1,14,5,9,NPC
trimetozine_10uM_24h,trimetozine,10 uM,24 h,4,25,29,1,0,0,0,NPC
verteporfin_10uM_24h,verteporfin,10 uM,24 h,4,25,29,1,11,2,9,NPC
chlorambucil_10uM_24h,chlorambucil,10 uM,24 h,4,25,29,1,19,10,9,NPC
flavoxate_10uM_24h,flavoxate,10 uM,24 h,4,25,29,1,9,5,4,NPC
levomepromazine_10uM_24h,levomepromazine,10 uM,24 h,4,25,29,1,53,22,31,NPC
azaperone_10uM_24h,azaperone,10 uM,24 h,4,25,29,1,0,0,0,NPC
guanaben-acetate_10uM_24h,guanaben-acetate,10 uM,24 h,4,20,24,1,0,0,0,NPC
fluphenazine_10uM_24h,fluphenazine,10 uM,24 h,4,25,29,1,5,3,2,NPC
buspirone_10uM_24h,buspirone,10 uM,24 h,4,20,24,1,0,0,0,NPC
ranolazine_10uM_24h,ranolazine,10 uM,24 h,4,25,29,1,0,0,0,NPC
cefotiam_10uM_24h,cefotiam,10 uM,24 h,4,25,29,1,4,2,2,NPC
lamotrigine_10uM_24h,lamotrigine,10 uM,24 h,4,20,24,1,5,1,4,NPC
mepyramine_10uM_24h,mepyramine,10 uM,24 h,4,25,29,1,2,0,2,NPC
exemestane_10uM_24h,exemestane,10 uM,24 h,4,25,29,1,15,9,6,NPC
doxylamine_10uM_24h,doxylamine,10 uM,24 h,4,25,29,1,2,2,0,NPC
talniflumate_10uM_24h,talniflumate,10 uM,24 h,4,25,29,1,132,49,83,NPC
alfuzosin_10uM_24h,alfuzosin,10 uM,24 h,4,25,29,1,0,0,0,NPC
prazosin_10uM_24h,prazosin,10 uM,24 h,4,25,29,1,6,1,5,NPC
diflunisal_10uM_24h,diflunisal,10 uM,24 h,4,25,29,1,19,9,10,NPC
bupropion_10uM_24h,bupropion,10 uM,24 h,4,25,29,1,0,0,0,NPC
domperidone_10uM_24h,domperidone,10 uM,24 h,4,25,29,1,1,1,0,NPC
pindolol_10uM_24h,pindolol,10 uM,24 h,4,25,29,1,1,1,0,NPC
sertraline_10uM_24h,sertraline,10 uM,24 h,4,25,29,1,41,20,21,NPC
glipizide_10uM_24h,glipizide,10 uM,24 h,4,25,29,1,10,0,10,NPC
biotin_10uM_24h,biotin,10 uM,24 h,4,25,29,1,21,10,11,NPC
guanfacine_10uM_24h,guanfacine,10 uM,24 h,4,25,29,1,1,0,1,NPC
clofarabine_10uM_24h,clofarabine,10 uM,24 h,4,20,24,1,223,112,111,NPC
benzylpenicillin_10uM_24h,benzylpenicillin,10 uM,24 h,4,25,29,1,11,0,11,NPC
bicalutamide_10uM_24h,bicalutamide,10 uM,24 h,4,25,29,1,3,1,2,NPC
pentoxifylline_10uM_24h,pentoxifylline,10 uM,24 h,4,25,29,1,0,0,0,NPC
bendroflumethiazide_10uM_24h,bendroflumethiazide,10 uM,24 h,4,20,24,1,195,78,117,NPC
bepridil_10uM_24h,bepridil,10 uM,24 h,4,20,24,1,105,51,54,NPC
cortisone-acetate_10uM_24h,cortisone-acetate,10 uM,24 h,4,25,29,1,0,0,0,NPC
toremifene_10uM_24h,toremifene,10 uM,24 h,4,25,29,1,109,40,69,NPC
pantoprazole_10uM_24h,pantoprazole,10 uM,24 h,4,25,29,1,1,0,1,NPC
resorcinol_10uM_24h,resorcinol,10 uM,24 h,4,25,29,1,1,1,0,NPC
ketanserin_10uM_24h,ketanserin,10 uM,24 h,4,20,24,1,102,54,48,NPC
felbamate_10uM_24h,felbamate,10 uM,24 h,4,25,29,1,119,44,75,NPC
trimethobenzamide_10uM_24h,trimethobenzamide,10 uM,24 h,4,25,29,1,1,0,1,NPC
thiethylperazine_10uM_24h,thiethylperazine,10 uM,24 h,4,20,24,1,144,64,80,NPC
anagrelide_10uM_24h,anagrelide,10 uM,24 h,4,25,29,1,272,99,173,NPC
budesonide_10uM_24h,budesonide,10 uM,24 h,4,20,24,1,27,19,8,NPC
hydrocortisone-valerate_10uM_24h,hydrocortisone-valerate,10 uM,24 h,4,25,29,1,8,0,8,NPC
propoxycaine_10uM_24h,propoxycaine,10 uM,24 h,4,20,24,1,102,43,59,NPC
rizatriptan_10uM_24h,rizatriptan,10 uM,24 h,4,25,29,1,33,2,31,NPC
ornidazole_10uM_24h,ornidazole,10 uM,24 h,4,25,29,1,26,4,22,NPC
ibudilast_10uM_24h,ibudilast,10 uM,24 h,4,25,29,1,113,44,69,NPC
milrinone_10uM_24h,milrinone,10 uM,24 h,4,25,29,1,209,67,142,NPC
telmisartan_10uM_24h,telmisartan,10 uM,24 h,4,20,24,1,28,13,15,NPC
salmeterol_10uM_24h,salmeterol,10 uM,24 h,4,25,29,1,6,3,3,NPC
NECA_10uM_24h,NECA,10 uM,24 h,4,25,29,1,0,0,0,NPC
sildenafil_10uM_24h,sildenafil,10 uM,24 h,4,25,29,1,8,1,7,NPC
tolbutamide_10uM_24h,tolbutamide,10 uM,24 h,4,25,29,1,4,2,2,NPC
temefos_10uM_24h,temefos,10 uM,24 h,4,25,29,1,0,0,0,NPC
prochlorperazine_10uM_24h,prochlorperazine,10 uM,24 h,4,25,29,1,38,4,34,NPC
halcinonide_10uM_24h,halcinonide,10 uM,24 h,4,20,24,1,232,84,148,NPC
cyclopenthiazide_10uM_24h,cyclopenthiazide,10 uM,24 h,4,25,29,1,9,5,4,NPC
phenazone_10uM_24h,phenazone,10 uM,24 h,4,25,29,1,3,0,3,NPC
procarbazine_10uM_24h,procarbazine,10 uM,24 h,4,25,29,1,0,0,0,NPC
felodipine_10uM_24h,felodipine,10 uM,24 h,4,25,29,1,1,0,1,NPC
ticlopidine_10uM_24h,ticlopidine,10 uM,24 h,4,25,29,1,24,3,21,NPC
nilutamide_10uM_24h,nilutamide,10 uM,24 h,4,25,29,1,0,0,0,NPC
nicergoline_10uM_24h,nicergoline,10 uM,24 h,4,20,24,1,2,1,1,NPC
mometasone_10uM_24h,mometasone,10 uM,24 h,4,25,29,1,53,12,41,NPC
albendazole_10uM_24h,albendazole,10 uM,24 h,4,25,29,1,63,23,40,NPC
bosutinib_10uM_6h,bosutinib,10 uM,6 h,4,20,24,2,280,81,199,NPC
protriptyline_10uM_24h,protriptyline,10 uM,24 h,4,25,29,1,2,1,1,NPC
trimipramine_10uM_24h,trimipramine,10 uM,24 h,4,20,24,1,131,75,56,NPC
coumarin_10uM_24h,coumarin,10 uM,24 h,4,25,29,1,1,0,1,NPC
triamterene_10uM_24h,triamterene,10 uM,24 h,4,25,29,1,1,0,1,NPC
venlafaxine_10uM_24h,venlafaxine,10 uM,24 h,4,25,29,1,0,0,0,NPC
levonorgestrel_10uM_24h,levonorgestrel,10 uM,24 h,4,20,24,1,0,0,0,NPC
estropipate_10uM_24h,estropipate,10 uM,24 h,4,25,29,1,62,18,44,NPC
propofol_10uM_24h,propofol,10 uM,24 h,4,25,29,1,0,0,0,NPC
oxfendazole_10uM_24h,oxfendazole,10 uM,24 h,4,25,29,1,4,1,3,NPC
tetramisole_10uM_24h,tetramisole,10 uM,24 h,4,25,29,1,76,23,53,NPC
fipronil_10uM_24h,fipronil,10 uM,24 h,4,25,29,1,4,2,2,NPC
pizotifen_10uM_24h,pizotifen,10 uM,24 h,4,25,29,1,13,3,10,NPC
ozagrel_10uM_24h,ozagrel,10 uM,24 h,4,25,29,1,0,0,0,NPC
clocortolone-pivalate_10uM_24h,clocortolone-pivalate,10 uM,24 h,4,20,24,1,1,0,1,NPC
dantrolene_10uM_24h,dantrolene,10 uM,24 h,4,25,29,1,190,76,114,NPC
duloxetine_10uM_24h,duloxetine,10 uM,24 h,4,25,29,1,0,0,0,NPC
piroxicam_10uM_24h,piroxicam,10 uM,24 h,4,25,29,1,1,0,1,NPC
beclomethasone-dipropionate_10uM_24h,beclomethasone-dipropionate,10 uM,24 h,4,20,24,1,1,1,0,NPC
formestane_10uM_24h,formestane,10 uM,24 h,4,25,29,1,21,5,16,NPC
procainamide_10uM_24h,procainamide,10 uM,24 h,4,25,29,1,0,0,0,NPC
phentolamine_10uM_24h,phentolamine,10 uM,24 h,4,25,29,1,0,0,0,NPC
triclosan_10uM_24h,triclosan,10 uM,24 h,4,25,29,1,183,82,101,NPC
ciprofibrate_10uM_24h,ciprofibrate,10 uM,24 h,4,25,29,1,0,0,0,NPC
piperidolate_10uM_24h,piperidolate,10 uM,24 h,4,20,24,1,0,0,0,NPC
procaterol_10uM_24h,procaterol,10 uM,24 h,4,20,24,1,188,88,100,NPC
brimonidine_10uM_24h,brimonidine,10 uM,24 h,4,20,24,1,85,43,42,NPC
leflunomide_10uM_24h,leflunomide,10 uM,24 h,4,25,29,1,0,0,0,NPC
disopyramide_10uM_24h,disopyramide,10 uM,24 h,4,25,29,1,0,0,0,NPC
irbesartan_10uM_24h,irbesartan,10 uM,24 h,4,25,29,1,21,3,18,NPC
famciclovir_10uM_24h,famciclovir,10 uM,24 h,4,25,29,1,261,92,169,NPC
aminopentamide_10uM_24h,aminopentamide,10 uM,24 h,4,25,29,1,31,4,27,NPC
talipexole_10uM_24h,talipexole,10 uM,24 h,4,20,24,1,104,41,63,NPC
melperone_10uM_24h,melperone,10 uM,24 h,4,20,24,1,252,101,151,NPC
benperidol_10uM_24h,benperidol,10 uM,24 h,4,20,24,1,1,1,0,NPC
etomidate_10uM_24h,etomidate,10 uM,24 h,4,25,29,1,3,2,1,NPC
carbinoxamine_10uM_24h,carbinoxamine,10 uM,24 h,4,25,29,1,0,0,0,NPC
midodrine_10uM_24h,midodrine,10 uM,24 h,4,25,29,1,1,0,1,NPC
amantadine_10uM_24h,amantadine,10 uM,24 h,4,25,29,1,2,1,1,NPC
fexofenadine_10uM_24h,fexofenadine,10 uM,24 h,4,25,29,1,0,0,0,NPC
metergoline_10uM_24h,metergoline,10 uM,24 h,4,25,29,1,0,0,0,NPC
droperidol_10uM_24h,droperidol,10 uM,24 h,4,20,24,1,0,0,0,NPC
sulconazole_10uM_24h,sulconazole,10 uM,24 h,4,25,29,1,133,37,96,NPC
somatostatin_10uM_24h,somatostatin,10 uM,24 h,3,17,20,1,4,2,2,NPC
GR-235_10uM_24h,GR-235,10 uM,24 h,3,17,20,1,9,5,4,NPC
ubenimex_10uM_24h,ubenimex,10 uM,24 h,3,16,19,1,1,0,1,NPC
vecuronium_10uM_24h,vecuronium,10 uM,24 h,3,17,20,1,19,13,6,NPC
sulfafurazole_10uM_24h,sulfafurazole,10 uM,24 h,3,8,11,1,0,0,0,NPC
palbociclib_10uM_24h,palbociclib,10 uM,24 h,3,17,20,1,3,0,3,NPC
sitagliptin_10uM_24h,sitagliptin,10 uM,24 h,3,17,20,1,101,39,62,NPC
rifabutin_10uM_24h,rifabutin,10 uM,24 h,3,17,20,1,2,2,0,NPC
naphazoline_10uM_24h,naphazoline,10 uM,24 h,3,8,11,1,0,0,0,NPC
terconazole_10uM_24h,terconazole,10 uM,24 h,3,9,12,1,0,0,0,NPC
linezolid_10uM_24h,linezolid,10 uM,24 h,3,17,20,1,7,4,3,NPC
docetaxel_10uM_24h,docetaxel,10 uM,24 h,3,17,20,1,90,35,55,NPC
nilotinib_10uM_24h,nilotinib,10 uM,24 h,3,17,20,1,8,6,2,NPC
mosapride_10uM_24h,mosapride,10 uM,24 h,3,17,20,1,1,0,1,NPC
fenoldopam_10uM_24h,fenoldopam,10 uM,24 h,3,8,11,1,0,0,0,NPC
fluconazole_10uM_24h,fluconazole,10 uM,24 h,3,18,21,1,0,0,0,NPC
cilastatin_10uM_24h,cilastatin,10 uM,24 h,3,9,12,1,25,4,21,NPC
teicoplanin_10uM_24h,teicoplanin,10 uM,24 h,3,17,20,1,0,0,0,NPC
prednisolone-acetate_10uM_24h,prednisolone-acetate,10 uM,24 h,3,17,20,1,28,12,16,NPC
dicycloverine_10uM_24h,dicycloverine,10 uM,24 h,3,16,19,1,2,1,1,NPC
benzonatate_10uM_24h,benzonatate,10 uM,24 h,3,19,22,1,0,0,0,NPC
nalbuphine_10uM_24h,nalbuphine,10 uM,24 h,3,8,11,1,0,0,0,NPC
hyoscyamine_10uM_24h,hyoscyamine,10 uM,24 h,3,8,11,1,0,0,0,NPC
raltitrexed_10uM_24h,raltitrexed,10 uM,24 h,3,17,20,1,9,3,6,NPC
hesperidin_10uM_24h,hesperidin,10 uM,24 h,3,8,11,1,0,0,0,NPC
tadalafil_10uM_24h,tadalafil,10 uM,24 h,3,18,21,1,1,0,1,NPC
triamcinolone_10uM_24h,triamcinolone,10 uM,24 h,3,8,11,1,0,0,0,NPC
clomipramine_10uM_24h,clomipramine,10 uM,24 h,3,8,11,1,0,0,0,NPC
pimozide_10uM_6h,pimozide,10 uM,6 h,3,12,15,1,4,1,3,NPC
floxuridine_10uM_24h,floxuridine,10 uM,24 h,3,17,20,1,14,9,5,NPC
fenbendazole_10uM_24h,fenbendazole,10 uM,24 h,3,8,11,1,31,3,28,NPC
norgestrel_10uM_24h,norgestrel,10 uM,24 h,3,8,11,1,0,0,0,NPC
oxybenzone_10uM_24h,oxybenzone,10 uM,24 h,3,8,11,1,0,0,0,NPC
nortriptyline_10uM_24h,nortriptyline,10 uM,24 h,3,8,11,1,3,1,2,NPC
metaxalone_10uM_24h,metaxalone,10 uM,24 h,3,18,21,1,1,0,1,NPC
buphenine_10uM_24h,buphenine,10 uM,24 h,3,8,11,1,0,0,0,NPC
pirarubicin_10uM_24h,pirarubicin,10 uM,24 h,3,17,20,1,534,244,290,NPC
molsidomine_10uM_24h,molsidomine,10 uM,24 h,3,8,11,1,0,0,0,NPC
acepromazine_10uM_24h,acepromazine,10 uM,24 h,3,8,11,1,0,0,0,NPC
prednisolone_10uM_24h,prednisolone,10 uM,24 h,3,18,21,1,5,2,3,NPC
diethyltoluamide_10uM_24h,diethyltoluamide,10 uM,24 h,3,8,11,1,0,0,0,NPC
axitinib_10uM_24h,axitinib,10 uM,24 h,3,17,20,1,369,145,224,NPC
erlotinib_10uM_24h,erlotinib,10 uM,24 h,3,17,20,1,2,1,1,NPC
bemegride_10uM_24h,bemegride,10 uM,24 h,3,8,11,1,1,1,0,NPC
praziquantel_10uM_24h,praziquantel,10 uM,24 h,3,18,21,1,20,2,18,NPC
parachlorophenol_10uM_24h,parachlorophenol,10 uM,24 h,3,8,11,1,0,0,0,NPC
treprostinil_10uM_24h,treprostinil,10 uM,24 h,3,9,12,1,11,3,8,NPC
timolol_10uM_24h,timolol,10 uM,24 h,3,8,11,1,0,0,0,NPC
pargyline_10uM_24h,pargyline,10 uM,24 h,3,8,11,1,2,2,0,NPC
oxybuprocaine_10uM_24h,oxybuprocaine,10 uM,24 h,3,18,21,1,203,86,117,NPC
pyrvinium-pamoate_10uM_24h,pyrvinium-pamoate,10 uM,24 h,3,29,32,1,329,146,183,NPC
fenofibrate_10uM_24h,fenofibrate,10 uM,24 h,3,8,11,1,0,0,0,NPC
ropinirole_10uM_24h,ropinirole,10 uM,24 h,3,18,21,1,6,1,5,NPC
tamibarotene_10uM_24h,tamibarotene,10 uM,24 h,3,17,20,1,10,5,5,NPC
metoclopramide_10uM_24h,metoclopramide,10 uM,24 h,3,8,11,1,0,0,0,NPC
acamprosate_10uM_24h,acamprosate,10 uM,24 h,3,8,11,1,0,0,0,NPC
lenalidomide_10uM_24h,lenalidomide,10 uM,24 h,3,17,20,1,3,1,2,NPC
ziprasidone_10uM_24h,ziprasidone,10 uM,24 h,3,17,20,1,1,0,1,NPC
nelfinavir_10uM_24h,nelfinavir,10 uM,24 h,3,17,20,1,0,0,0,NPC
cinacalcet_10uM_24h,cinacalcet,10 uM,24 h,3,17,20,1,0,0,0,NPC
rosmarinic-acid_10uM_24h,rosmarinic-acid,10 uM,24 h,3,8,11,1,0,0,0,NPC
norgestimate_10uM_24h,norgestimate,10 uM,24 h,3,25,28,1,4,3,1,NPC
maprotiline_10uM_24h,maprotiline,10 uM,24 h,3,8,11,1,0,0,0,NPC
epirizole_10uM_24h,epirizole,10 uM,24 h,3,8,11,1,0,0,0,NPC
dobutamine_10uM_24h,dobutamine,10 uM,24 h,3,8,11,1,0,0,0,NPC
tofacitinib_10uM_24h,tofacitinib,10 uM,24 h,3,17,20,1,0,0,0,NPC
iloperidone_10uM_24h,iloperidone,10 uM,24 h,3,17,20,1,2,1,1,NPC
raltegravir_10uM_24h,raltegravir,10 uM,24 h,3,17,20,1,2,1,1,NPC
metolazone_10uM_24h,metolazone,10 uM,24 h,3,8,11,1,1,1,0,NPC
iobenguane_10uM_24h,iobenguane,10 uM,24 h,3,8,11,1,0,0,0,NPC
pheniramine_10uM_24h,pheniramine,10 uM,24 h,3,8,11,1,0,0,0,NPC
epirubicin_10uM_24h,epirubicin,10 uM,24 h,3,29,32,1,622,234,388,NPC
aprepitant_10uM_24h,aprepitant,10 uM,24 h,3,17,20,1,0,0,0,NPC
panobinostat_10uM_24h,panobinostat,10 uM,24 h,3,9,12,1,380,175,205,NPC
entecavir_10uM_24h,entecavir,10 uM,24 h,3,17,20,1,0,0,0,NPC
fasudil_10uM_24h,fasudil,10 uM,24 h,3,8,11,1,0,0,0,NPC
mesoridazine_10uM_24h,mesoridazine,10 uM,24 h,3,8,11,1,14,7,7,NPC
erythromycin-ethylsuccinate_10uM_24h,erythromycin-ethylsuccinate,10 uM,24 h,3,8,11,1,0,0,0,NPC
brinzolamide_10uM_24h,brinzolamide,10 uM,24 h,3,8,11,1,3,2,1,NPC
hexylcaine_10uM_24h,hexylcaine,10 uM,24 h,3,8,11,1,0,0,0,NPC
papaverine_10uM_24h,papaverine,10 uM,24 h,3,8,11,1,0,0,0,NPC
promazine_10uM_24h,promazine,10 uM,24 h,3,8,11,1,1,0,1,NPC
nafcillin_10uM_24h,nafcillin,10 uM,24 h,3,9,12,1,0,0,0,NPC
xylazine_10uM_24h,xylazine,10 uM,24 h,3,15,18,1,16,12,4,NPC
phenazopyridine_10uM_24h,phenazopyridine,10 uM,24 h,3,8,11,1,0,0,0,NPC
tranilast_10uM_24h,tranilast,10 uM,24 h,3,8,11,1,0,0,0,NPC
warfarin_10uM_24h,warfarin,10 uM,24 h,3,17,20,1,0,0,0,NPC
thioproperazine_10uM_24h,thioproperazine,10 uM,24 h,3,8,11,1,0,0,0,NPC
febuxostat_10uM_24h,febuxostat,10 uM,24 h,3,8,11,1,0,0,0,NPC
mofezolac_10uM_24h,mofezolac,10 uM,24 h,3,9,12,1,0,0,0,NPC
lypressin_10uM_24h,lypressin,10 uM,24 h,3,17,20,1,3,2,1,NPC
doxercalciferol_10uM_24h,doxercalciferol,10 uM,24 h,3,9,12,1,0,0,0,NPC
tolmetin_10uM_24h,tolmetin,10 uM,24 h,3,18,21,1,10,0,10,NPC
vemurafenib_10uM_24h,vemurafenib,10 uM,24 h,3,17,20,1,41,12,29,NPC
fludarabine_10uM_24h,fludarabine,10 uM,24 h,3,17,20,1,1,0,1,NPC
amiloride_10uM_24h,amiloride,10 uM,24 h,3,8,11,1,0,0,0,NPC
voriconazole_10uM_24h,voriconazole,10 uM,24 h,3,17,20,1,0,0,0,NPC
gabexate_10uM_24h,gabexate,10 uM,24 h,3,8,11,1,0,0,0,NPC
capecitabine_10uM_24h,capecitabine,10 uM,24 h,3,17,20,1,5,4,1,NPC
methocarbamol_10uM_24h,methocarbamol,10 uM,24 h,3,8,11,1,1,1,0,NPC
lasalocid_10uM_24h,lasalocid,10 uM,24 h,3,8,11,1,177,73,104,NPC
racecadotril_10uM_24h,racecadotril,10 uM,24 h,3,25,28,1,145,81,64,NPC
metoprolol_10uM_24h,metoprolol,10 uM,24 h,3,8,11,1,0,0,0,NPC
moxifloxacin_10uM_24h,moxifloxacin,10 uM,24 h,3,17,20,1,4,2,2,NPC
estradiol-cypionate_10uM_24h,estradiol-cypionate,10 uM,24 h,3,8,11,1,0,0,0,NPC
mebendazole_10uM_24h,mebendazole,10 uM,24 h,3,8,11,1,27,11,16,NPC
oxymetazoline_10uM_24h,oxymetazoline,10 uM,24 h,3,8,11,1,0,0,0,NPC
diphenidol_10uM_24h,diphenidol,10 uM,24 h,3,8,11,1,0,0,0,NPC
carbetocin_10uM_24h,carbetocin,10 uM,24 h,3,17,20,1,69,31,38,NPC
mefenamic-acid_10uM_24h,mefenamic-acid,10 uM,24 h,3,8,11,1,0,0,0,NPC
ethisterone_10uM_24h,ethisterone,10 uM,24 h,3,8,11,1,0,0,0,NPC
safinamide_10uM_24h,safinamide,10 uM,24 h,3,17,20,1,0,0,0,NPC
teniposide_10uM_24h,teniposide,10 uM,24 h,3,19,22,1,574,221,353,NPC
flupirtine_10uM_24h,flupirtine,10 uM,24 h,3,17,20,1,0,0,0,NPC
omeprazole_10uM_24h,omeprazole,10 uM,24 h,3,15,18,1,57,11,46,NPC
benazepril_10uM_24h,benazepril,10 uM,24 h,3,8,11,1,0,0,0,NPC
meclofenamic-acid_10uM_24h,meclofenamic-acid,10 uM,24 h,3,8,11,1,0,0,0,NPC
probucol_10uM_24h,probucol,10 uM,24 h,3,8,11,1,0,0,0,NPC
picotamide_10uM_24h,picotamide,10 uM,24 h,3,25,28,1,227,81,146,NPC
nomegestrol-acetate_10uM_24h,nomegestrol-acetate,10 uM,24 h,3,8,11,1,1,1,0,NPC
orphenadrine_10uM_24h,orphenadrine,10 uM,24 h,3,8,11,1,0,0,0,NPC
nifedipine_10uM_24h,nifedipine,10 uM,24 h,3,8,11,1,0,0,0,NPC
meclizine_10uM_24h,meclizine,10 uM,24 h,3,8,11,1,3,2,1,NPC
iloprost_10uM_24h,iloprost,10 uM,24 h,3,17,20,1,33,12,21,NPC
ketorolac_10uM_24h,ketorolac,10 uM,24 h,3,18,21,1,3,0,3,NPC
palmitoylethanolamide_10uM_24h,palmitoylethanolamide,10 uM,24 h,3,8,11,1,0,0,0,NPC
mirtazapine_10uM_24h,mirtazapine,10 uM,24 h,3,12,15,1,1,0,1,NPC
lopinavir_10uM_24h,lopinavir,10 uM,24 h,3,17,20,1,0,0,0,NPC
crizotinib_10uM_24h,crizotinib,10 uM,24 h,3,17,20,1,469,188,281,NPC
rivaroxaban_10uM_24h,rivaroxaban,10 uM,24 h,3,17,20,1,2,1,1,NPC
wortmannin_10uM_24h,wortmannin,10 uM,24 h,50,456,506,13,273,97,176,NPC
geldanamycin_10uM_24h,geldanamycin,10 uM,24 h,37,345,382,12,715,260,455,NPC
PD-0325901_10uM_24h,PD-0325901,10 uM,24 h,34,654,688,11,429,240,189,NPC
tacedinaline_10uM_24h,tacedinaline,10 uM,24 h,33,441,474,7,806,337,469,NPC
entinostat_10uM_24h,entinostat,10 uM,24 h,30,690,720,10,763,352,411,NPC
tanespimycin_10uM_24h,tanespimycin,10 uM,24 h,29,627,656,11,744,262,482,NPC
CHIR-99021_10uM_24h,CHIR-99021,10 uM,24 h,25,481,506,9,286,132,154,NPC
PD-0325901_0.04uM_24h,PD-0325901,0.04 uM,24 h,25,598,623,9,191,138,53,NPC
PD-0325901_0.12uM_24h,PD-0325901,0.12 uM,24 h,25,598,623,9,140,82,58,NPC
PD-0325901_0.37uM_24h,PD-0325901,0.37 uM,24 h,25,598,623,9,271,163,108,NPC
PD-0325901_3.33uM_24h,PD-0325901,3.33 uM,24 h,25,598,623,9,372,235,137,NPC
PD-0325901_1.11uM_24h,PD-0325901,1.11 uM,24 h,24,577,601,9,301,179,122,NPC
BIX-01294_10uM_24h,BIX-01294,10 uM,24 h,22,501,523,9,745,314,431,NPC
pyrazolanthrone_10uM_24h,pyrazolanthrone,10 uM,24 h,19,292,311,6,79,29,50,NPC
SB-216763_10uM_24h,SB-216763,10 uM,24 h,19,211,230,5,116,52,64,NPC
troglitazone_3.33uM_24h,troglitazone,3.33 uM,24 h,19,440,459,7,129,42,87,NPC
rolipram_10uM_24h,rolipram,10 uM,24 h,18,415,433,6,2,2,0,NPC
veliparib_10uM_24h,veliparib,10 uM,24 h,18,445,463,6,26,26,0,NPC
D-4476_10uM_24h,D-4476,10 uM,24 h,18,284,302,6,337,134,203,NPC
troglitazone_10uM_24h,troglitazone,10 uM,24 h,18,157,175,4,0,0,0,NPC
tacedinaline_10uM_6h,tacedinaline,10 uM,6 h,18,55,73,2,371,122,249,NPC
veliparib_0.04uM_24h,veliparib,0.04 uM,24 h,18,445,463,6,11,4,7,NPC
veliparib_0.12uM_24h,veliparib,0.12 uM,24 h,18,445,463,6,203,57,146,NPC
veliparib_0.37uM_24h,veliparib,0.37 uM,24 h,18,445,463,6,0,0,0,NPC
veliparib_1.11uM_24h,veliparib,1.11 uM,24 h,18,445,463,6,4,3,1,NPC
veliparib_3.33uM_24h,veliparib,3.33 uM,24 h,18,445,463,6,27,18,9,NPC
geldanamycin_10uM_6h,geldanamycin,10 uM,6 h,17,109,126,4,244,98,146,NPC
wortmannin_10uM_6h,wortmannin,10 uM,6 h,17,109,126,4,209,75,134,NPC
GW-9662_10uM_24h,GW-9662,10 uM,24 h,16,98,114,3,3,1,2,NPC
cycloheximide_10uM_24h,cycloheximide,10 uM,24 h,16,137,153,4,285,136,149,NPC
apigenin_10uM_24h,apigenin,10 uM,24 h,15,119,134,4,0,0,0,NPC
PF-02545920_10uM_24h,PF-02545920,10 uM,24 h,15,383,398,5,25,14,11,NPC
SB-203580_10uM_24h,SB-203580,10 uM,24 h,15,240,255,5,19,7,12,NPC
EX-527_10uM_24h,EX-527,10 uM,24 h,15,309,324,5,14,9,5,NPC
KU-55933_10uM_24h,KU-55933,10 uM,24 h,15,280,295,4,35,14,21,NPC
ZM-447439_10uM_24h,ZM-447439,10 uM,24 h,15,250,265,5,64,30,34,NPC
SB-239063_10uM_24h,SB-239063,10 uM,24 h,14,245,259,5,21,8,13,NPC
TTNPB_10uM_24h,TTNPB,10 uM,24 h,13,126,139,4,29,10,19,NPC
motesanib_10uM_24h,motesanib,10 uM,24 h,13,209,222,5,87,28,59,NPC
GW-5074_10uM_24h,GW-5074,10 uM,24 h,13,231,244,4,17,12,5,NPC
piceatannol_10uM_24h,piceatannol,10 uM,24 h,13,129,142,4,408,174,234,NPC
NU-7026_10uM_24h,NU-7026,10 uM,24 h,13,288,301,4,10,3,7,NPC
genistein_10uM_24h,genistein,10 uM,24 h,13,126,139,4,0,0,0,NPC
anandamide_10uM_24h,anandamide,10 uM,24 h,13,130,143,4,0,0,0,NPC
VX-745_10uM_24h,VX-745,10 uM,24 h,12,223,235,4,10,7,3,NPC
mocetinostat_10uM_24h,mocetinostat,10 uM,24 h,12,280,292,4,547,252,295,NPC
SB-216763_10uM_6h,SB-216763,10 uM,6 h,12,55,67,2,9,4,5,NPC
GW-9662_10uM_6h,GW-9662,10 uM,6 h,12,55,67,2,3,1,2,NPC
GDC-0879_10uM_24h,GDC-0879,10 uM,24 h,12,223,235,4,38,23,15,NPC
GNF-2_10uM_24h,GNF-2,10 uM,24 h,12,221,233,4,32,12,20,NPC
HMN-214_10uM_24h,HMN-214,10 uM,24 h,12,223,235,4,462,214,248,NPC
troglitazone_10uM_6h,troglitazone,10 uM,6 h,12,55,67,2,0,0,0,NPC
thioperamide_10uM_24h,thioperamide,10 uM,24 h,12,137,149,4,0,0,0,NPC
sirtinol_10uM_6h,sirtinol,10 uM,6 h,11,109,120,4,0,0,0,NPC
XAV-939_10uM_24h,XAV-939,10 uM,24 h,11,124,135,4,41,17,24,NPC
splitomycin_10uM_24h,splitomycin,10 uM,24 h,11,124,135,4,0,0,0,NPC
CHIR-99021_10uM_6h,CHIR-99021,10 uM,6 h,11,109,120,4,51,27,24,NPC
sirtinol_10uM_24h,sirtinol,10 uM,24 h,11,124,135,4,0,0,0,NPC
splitomycin_10uM_6h,splitomycin,10 uM,6 h,11,109,120,4,0,0,0,NPC
TAK-715_10uM_24h,TAK-715,10 uM,24 h,11,202,213,4,14,11,3,NPC
XAV-939_10uM_6h,XAV-939,10 uM,6 h,11,109,120,4,11,2,9,NPC
CGK-733_10uM_24h,CGK-733,10 uM,24 h,11,268,279,4,720,324,396,NPC
FK-866_10uM_24h,FK-866,10 uM,24 h,11,124,135,4,0,0,0,NPC
BIX-01294_10uM_6h,BIX-01294,10 uM,6 h,11,77,88,5,308,84,224,NPC
FK-866_10uM_6h,FK-866,10 uM,6 h,11,109,120,4,0,0,0,NPC
kenpaullone_10uM_24h,kenpaullone,10 uM,24 h,10,98,108,3,33,9,24,NPC
GW-4064_10uM_24h,GW-4064,10 uM,24 h,10,95,105,3,26,2,24,NPC
SB-525334_10uM_24h,SB-525334,10 uM,24 h,10,182,192,4,8,4,4,NPC
PP-2_10uM_24h,PP-2,10 uM,24 h,10,97,107,3,282,100,182,NPC
oxidopamine_10uM_6h,oxidopamine,10 uM,6 h,10,54,64,2,7,4,3,NPC
SB-202190_10uM_24h,SB-202190,10 uM,24 h,10,98,108,3,47,15,32,NPC
ruboxistaurin_10uM_24h,ruboxistaurin,10 uM,24 h,10,255,265,4,740,363,377,NPC
triciribine_10uM_24h,triciribine,10 uM,24 h,10,101,111,3,0,0,0,NPC
BADGE_10uM_24h,BADGE,10 uM,24 h,10,97,107,3,0,0,0,NPC
quizartinib_10uM_24h,quizartinib,10 uM,24 h,10,182,192,4,148,65,83,NPC
dinoprostone_10uM_24h,dinoprostone,10 uM,24 h,10,97,107,3,158,43,115,NPC
oxidopamine_10uM_24h,oxidopamine,10 uM,24 h,10,66,76,2,246,116,130,NPC
AZ-628_10uM_24h,AZ-628,10 uM,24 h,10,182,192,4,275,134,141,NPC
scriptaid_10uM_24h,scriptaid,10 uM,24 h,10,95,105,3,503,263,240,NPC
AR-A014418_10uM_24h,AR-A014418,10 uM,24 h,10,97,107,3,3,0,3,NPC
luzindole_10uM_24h,luzindole,10 uM,24 h,9,105,114,3,0,0,0,NPC
nocodazole_10uM_24h,nocodazole,10 uM,24 h,9,103,112,3,229,112,117,NPC
A-769662_10uM_24h,A-769662,10 uM,24 h,9,194,203,3,1,1,0,NPC
JW-55_10uM_24h,JW-55,10 uM,24 h,9,251,260,3,23,12,11,NPC
CX-5461_10uM_24h,CX-5461,10 uM,24 h,9,251,260,3,88,52,36,NPC
saracatinib_10uM_24h,saracatinib,10 uM,24 h,9,120,129,4,530,190,340,NPC
mevastatin_10uM_24h,mevastatin,10 uM,24 h,9,106,115,3,114,46,68,NPC
KU-60019_10uM_24h,KU-60019,10 uM,24 h,9,251,260,3,40,28,12,NPC
PFI-1_10uM_24h,PFI-1,10 uM,24 h,9,251,260,3,397,220,177,NPC
I-BET-762_10uM_24h,I-BET-762,10 uM,24 h,9,251,260,3,404,220,184,NPC
MC1568_10uM_24h,MC1568,10 uM,24 h,9,251,260,3,4,2,2,NPC
ABT-737_10uM_24h,ABT-737,10 uM,24 h,9,251,260,3,71,41,30,NPC
KI-20227_10uM_24h,KI-20227,10 uM,24 h,9,194,203,3,5,5,0,NPC
GSK-J4_10uM_24h,GSK-J4,10 uM,24 h,9,251,260,3,172,79,93,NPC
IOX2_10uM_24h,IOX2,10 uM,24 h,9,251,260,3,17,12,5,NPC
CC-401_10uM_24h,CC-401,10 uM,24 h,9,194,203,3,288,139,149,NPC
BX-795_10uM_24h,BX-795,10 uM,24 h,9,194,203,3,181,95,86,NPC
oleoylethanolamide_10uM_24h,oleoylethanolamide,10 uM,24 h,9,87,96,3,7,2,5,NPC
NVP-BHG712_10uM_24h,NVP-BHG712,10 uM,24 h,9,194,203,3,335,162,173,NPC
pirinixic-acid_10uM_24h,pirinixic-acid,10 uM,24 h,9,90,99,3,0,0,0,NPC
Y-27632_10uM_24h,Y-27632,10 uM,24 h,9,251,260,3,4,1,3,NPC
CGS-21680_10uM_24h,CGS-21680,10 uM,24 h,9,106,115,3,18,8,10,NPC
BAY-61-3606_10uM_24h,BAY-61-3606,10 uM,24 h,9,194,203,3,404,190,214,NPC
daminozide_10uM_24h,daminozide,10 uM,24 h,9,251,260,3,7,7,0,NPC
ciglitazone_10uM_24h,ciglitazone,10 uM,24 h,9,90,99,3,5,0,5,NPC
acadesine_10uM_24h,acadesine,10 uM,24 h,9,90,99,3,0,0,0,NPC
GSK-J2_10uM_24h,GSK-J2,10 uM,24 h,9,251,260,3,16,14,2,NPC
CPCCOEt_10uM_24h,CPCCOEt,10 uM,24 h,9,103,112,3,0,0,0,NPC
U-0126_10uM_24h,U-0126,10 uM,24 h,9,61,70,2,5,0,5,NPC
rosiglitazone_10uM_24h,rosiglitazone,10 uM,24 h,9,90,99,3,0,0,0,NPC
iniparib_10uM_24h,iniparib,10 uM,24 h,9,251,260,3,3,3,0,NPC
BI-2536_10uM_24h,BI-2536,10 uM,24 h,9,194,203,3,40,18,22,NPC
AM-580_10uM_24h,AM-580,10 uM,24 h,9,90,99,3,5,5,0,NPC
JNJ-16259685_10uM_24h,JNJ-16259685,10 uM,24 h,9,105,114,3,4,4,0,NPC
EX-527_10uM_6h,EX-527,10 uM,6 h,9,57,66,3,2,1,1,NPC
rigosertib_10uM_24h,rigosertib,10 uM,24 h,9,194,203,3,547,260,287,NPC
serdemetan_10uM_24h,serdemetan,10 uM,24 h,9,194,203,3,84,58,26,NPC
MGCD-265_10uM_24h,MGCD-265,10 uM,24 h,9,194,203,3,142,51,91,NPC
ACY-1215_10uM_24h,ACY-1215,10 uM,24 h,9,251,260,3,568,283,285,NPC
YM-298198_10uM_24h,YM-298198,10 uM,24 h,9,105,114,3,0,0,0,NPC
PD-98059_10uM_24h,PD-98059,10 uM,24 h,9,90,99,3,0,0,0,NPC
rucaparib_10uM_24h,rucaparib,10 uM,24 h,9,251,260,3,60,29,31,NPC
fenobam_10uM_24h,fenobam,10 uM,24 h,9,106,115,3,3,3,0,NPC
exifone_10uM_6h,exifone,10 uM,6 h,9,57,66,3,0,0,0,NPC
JNJ-38877605_10uM_24h,JNJ-38877605,10 uM,24 h,9,194,203,3,3,1,2,NPC
SB-939_10uM_24h,SB-939,10 uM,24 h,9,251,260,3,665,347,318,NPC
TWS-119_10uM_24h,TWS-119,10 uM,24 h,9,89,98,3,516,177,339,NPC
SKF-81297_10uM_24h,SKF-81297,10 uM,24 h,9,105,114,3,4,1,3,NPC
GW-7647_10uM_24h,GW-7647,10 uM,24 h,9,87,96,3,131,69,62,NPC
D-4476_0.04uM_24h,D-4476,0.04 uM,24 h,9,194,203,3,74,47,27,NPC
GSK-J4_0.04uM_24h,GSK-J4,0.04 uM,24 h,9,251,260,3,36,30,6,NPC
ZM-447439_0.04uM_24h,ZM-447439,0.04 uM,24 h,9,194,203,3,14,7,7,NPC
VX-745_0.04uM_24h,VX-745,0.04 uM,24 h,9,194,203,3,0,0,0,NPC
BI-2536_0.04uM_24h,BI-2536,0.04 uM,24 h,9,194,203,3,14,5,9,NPC
JNJ-38877605_0.04uM_24h,JNJ-38877605,0.04 uM,24 h,9,194,203,3,2,1,1,NPC
CGK-733_0.04uM_24h,CGK-733,0.04 uM,24 h,9,251,260,3,0,0,0,NPC
TAK-715_0.04uM_24h,TAK-715,0.04 uM,24 h,9,194,203,3,0,0,0,NPC
KU-55933_0.04uM_24h,KU-55933,0.04 uM,24 h,9,251,260,3,0,0,0,NPC
GW-5074_0.04uM_24h,GW-5074,0.04 uM,24 h,9,194,203,3,0,0,0,NPC
NU-7026_0.04uM_24h,NU-7026,0.04 uM,24 h,9,251,260,3,4,3,1,NPC
saracatinib_0.04uM_24h,saracatinib,0.04 uM,24 h,9,194,203,3,1,1,0,NPC
CC-401_0.04uM_24h,CC-401,0.04 uM,24 h,9,194,203,3,66,38,28,NPC
BAY-61-3606_0.04uM_24h,BAY-61-3606,0.04 uM,24 h,9,194,203,3,11,9,2,NPC
GDC-0879_0.04uM_24h,GDC-0879,0.04 uM,24 h,9,194,203,3,2,1,1,NPC
I-BET-762_0.04uM_24h,I-BET-762,0.04 uM,24 h,9,251,260,3,25,14,11,NPC
mocetinostat_0.04uM_24h,mocetinostat,0.04 uM,24 h,9,251,260,3,226,125,101,NPC
KU-60019_0.04uM_24h,KU-60019,0.04 uM,24 h,9,251,260,3,8,4,4,NPC
MK-1775_0.04uM_24h,MK-1775,0.04 uM,24 h,9,251,260,3,201,79,122,NPC
HMN-214_0.04uM_24h,HMN-214,0.04 uM,24 h,9,194,203,3,29,20,9,NPC
ACY-1215_0.04uM_24h,ACY-1215,0.04 uM,24 h,9,251,260,3,11,9,2,NPC
GSK-J2_0.04uM_24h,GSK-J2,0.04 uM,24 h,9,251,260,3,0,0,0,NPC
Y-27632_0.04uM_24h,Y-27632,0.04 uM,24 h,9,251,260,3,1,1,0,NPC
SB-239063_0.04uM_24h,SB-239063,0.04 uM,24 h,9,194,203,3,0,0,0,NPC
rigosertib_0.04uM_24h,rigosertib,0.04 uM,24 h,9,194,203,3,177,84,93,NPC
SB-939_0.04uM_24h,SB-939,0.04 uM,24 h,9,251,260,3,222,122,100,NPC
MGCD-265_0.04uM_24h,MGCD-265,0.04 uM,24 h,9,194,203,3,110,50,60,NPC
NVP-BHG712_0.04uM_24h,NVP-BHG712,0.04 uM,24 h,9,194,203,3,138,68,70,NPC
EX-527_0.04uM_24h,EX-527,0.04 uM,24 h,9,251,260,3,234,101,133,NPC
CX-5461_0.04uM_24h,CX-5461,0.04 uM,24 h,9,251,260,3,56,22,34,NPC
ABT-737_0.04uM_24h,ABT-737,0.04 uM,24 h,9,251,260,3,5,2,3,NPC
iniparib_0.04uM_24h,iniparib,0.04 uM,24 h,9,251,260,3,0,0,0,NPC
PF-03758309_0.04uM_24h,PF-03758309,0.04 uM,24 h,9,194,203,3,345,194,151,NPC
GNF-2_0.04uM_24h,GNF-2,0.04 uM,24 h,9,194,203,3,1,0,1,NPC
BIX-01294_0.04uM_24h,BIX-01294,0.04 uM,24 h,9,251,260,3,6,2,4,NPC
GSK-J1_0.04uM_24h,GSK-J1,0.04 uM,24 h,9,251,260,3,4,2,2,NPC
PFI-1_0.04uM_24h,PFI-1,0.04 uM,24 h,9,251,260,3,7,2,5,NPC
VE-821_0.04uM_24h,VE-821,0.04 uM,24 h,9,251,260,3,0,0,0,NPC
A-769662_0.04uM_24h,A-769662,0.04 uM,24 h,9,194,203,3,90,57,33,NPC
MC1568_0.04uM_24h,MC1568,0.04 uM,24 h,9,251,260,3,0,0,0,NPC
rucaparib_0.04uM_24h,rucaparib,0.04 uM,24 h,9,251,260,3,19,14,5,NPC
daminozide_0.04uM_24h,daminozide,0.04 uM,24 h,9,251,260,3,0,0,0,NPC
BX-795_0.04uM_24h,BX-795,0.04 uM,24 h,9,194,203,3,0,0,0,NPC
entinostat_0.04uM_24h,entinostat,0.04 uM,24 h,9,251,260,3,72,40,32,NPC
IOX2_0.04uM_24h,IOX2,0.04 uM,24 h,9,251,260,3,4,2,2,NPC
pyrazolanthrone_0.04uM_24h,pyrazolanthrone,0.04 uM,24 h,9,194,203,3,1,1,0,NPC
serdemetan_0.04uM_24h,serdemetan,0.04 uM,24 h,9,194,203,3,6,3,3,NPC
KI-20227_0.04uM_24h,KI-20227,0.04 uM,24 h,9,194,203,3,7,4,3,NPC
Y-27632_0.12uM_24h,Y-27632,0.12 uM,24 h,9,251,260,3,0,0,0,NPC
IOX2_0.12uM_24h,IOX2,0.12 uM,24 h,9,251,260,3,2,0,2,NPC
PF-03758309_0.12uM_24h,PF-03758309,0.12 uM,24 h,9,194,203,3,410,229,181,NPC
iniparib_0.12uM_24h,iniparib,0.12 uM,24 h,9,251,260,3,1,0,1,NPC
GSK-J2_0.12uM_24h,GSK-J2,0.12 uM,24 h,9,251,260,3,2,1,1,NPC
entinostat_0.12uM_24h,entinostat,0.12 uM,24 h,9,251,260,3,139,88,51,NPC
JNJ-38877605_0.12uM_24h,JNJ-38877605,0.12 uM,24 h,9,194,203,3,1,0,1,NPC
daminozide_0.12uM_24h,daminozide,0.12 uM,24 h,9,251,260,3,1,1,0,NPC
BAY-61-3606_0.12uM_24h,BAY-61-3606,0.12 uM,24 h,9,194,203,3,15,10,5,NPC
ABT-737_0.12uM_24h,ABT-737,0.12 uM,24 h,9,251,260,3,4,1,3,NPC
PF-573228_0.12uM_24h,PF-573228,0.12 uM,24 h,9,194,203,3,2,1,1,NPC
VX-745_0.12uM_24h,VX-745,0.12 uM,24 h,9,194,203,3,13,8,5,NPC
GDC-0879_0.12uM_24h,GDC-0879,0.12 uM,24 h,9,194,203,3,4,2,2,NPC
VE-821_0.12uM_24h,VE-821,0.12 uM,24 h,9,251,260,3,1,1,0,NPC
NVP-BHG712_0.12uM_24h,NVP-BHG712,0.12 uM,24 h,9,194,203,3,41,21,20,NPC
serdemetan_0.12uM_24h,serdemetan,0.12 uM,24 h,9,194,203,3,0,0,0,NPC
D-4476_0.12uM_24h,D-4476,0.12 uM,24 h,9,194,203,3,1,1,0,NPC
BX-795_0.12uM_24h,BX-795,0.12 uM,24 h,9,194,203,3,0,0,0,NPC
CX-5461_0.12uM_24h,CX-5461,0.12 uM,24 h,9,251,260,3,31,26,5,NPC
MC1568_0.12uM_24h,MC1568,0.12 uM,24 h,9,251,260,3,1,0,1,NPC
TAK-715_0.12uM_24h,TAK-715,0.12 uM,24 h,9,194,203,3,1,1,0,NPC
MGCD-265_0.12uM_24h,MGCD-265,0.12 uM,24 h,9,194,203,3,5,2,3,NPC
MK-1775_0.12uM_24h,MK-1775,0.12 uM,24 h,9,251,260,3,188,80,108,NPC
NU-7026_0.12uM_24h,NU-7026,0.12 uM,24 h,9,251,260,3,427,109,318,NPC
BIX-01294_0.12uM_24h,BIX-01294,0.12 uM,24 h,9,251,260,3,1,0,1,NPC
GSK-J1_0.12uM_24h,GSK-J1,0.12 uM,24 h,9,251,260,3,0,0,0,NPC
KI-20227_0.12uM_24h,KI-20227,0.12 uM,24 h,9,194,203,3,6,6,0,NPC
KU-60019_0.12uM_24h,KU-60019,0.12 uM,24 h,9,251,260,3,12,9,3,NPC
GSK-J4_0.12uM_24h,GSK-J4,0.12 uM,24 h,9,251,260,3,16,14,2,NPC
ACY-1215_0.12uM_24h,ACY-1215,0.12 uM,24 h,9,251,260,3,39,21,18,NPC
KU-55933_0.12uM_24h,KU-55933,0.12 uM,24 h,9,251,260,3,4,3,1,NPC
rigosertib_0.12uM_24h,rigosertib,0.12 uM,24 h,9,194,203,3,242,96,146,NPC
saracatinib_0.12uM_24h,saracatinib,0.12 uM,24 h,9,194,203,3,4,4,0,NPC
pyrazolanthrone_0.12uM_24h,pyrazolanthrone,0.12 uM,24 h,9,194,203,3,4,2,2,NPC
GW-5074_0.12uM_24h,GW-5074,0.12 uM,24 h,9,194,203,3,1,1,0,NPC
BI-2536_0.12uM_24h,BI-2536,0.12 uM,24 h,9,194,203,3,1,1,0,NPC
PFI-1_0.12uM_24h,PFI-1,0.12 uM,24 h,9,251,260,3,11,6,5,NPC
mocetinostat_0.12uM_24h,mocetinostat,0.12 uM,24 h,9,251,260,3,332,181,151,NPC
GNF-2_0.12uM_24h,GNF-2,0.12 uM,24 h,9,194,203,3,4,2,2,NPC
A-769662_0.12uM_24h,A-769662,0.12 uM,24 h,9,194,203,3,3,1,2,NPC
EX-527_0.12uM_24h,EX-527,0.12 uM,24 h,9,251,260,3,45,36,9,NPC
rucaparib_0.12uM_24h,rucaparib,0.12 uM,24 h,9,251,260,3,7,4,3,NPC
ZM-447439_0.12uM_24h,ZM-447439,0.12 uM,24 h,9,194,203,3,5,3,2,NPC
SB-239063_0.12uM_24h,SB-239063,0.12 uM,24 h,9,194,203,3,1,1,0,NPC
JW-55_0.12uM_24h,JW-55,0.12 uM,24 h,9,251,260,3,2,1,1,NPC
I-BET-762_0.12uM_24h,I-BET-762,0.12 uM,24 h,9,251,260,3,129,86,43,NPC
I-BET-762_0.37uM_24h,I-BET-762,0.37 uM,24 h,9,251,260,3,161,104,57,NPC
KU-55933_0.37uM_24h,KU-55933,0.37 uM,24 h,9,251,260,3,74,47,27,NPC
Y-27632_0.37uM_24h,Y-27632,0.37 uM,24 h,9,251,260,3,2,0,2,NPC
CGK-733_0.37uM_24h,CGK-733,0.37 uM,24 h,9,251,260,3,1,1,0,NPC
TAK-715_0.37uM_24h,TAK-715,0.37 uM,24 h,9,194,203,3,1,1,0,NPC
BX-795_0.37uM_24h,BX-795,0.37 uM,24 h,9,194,203,3,2,1,1,NPC
BI-2536_0.37uM_24h,BI-2536,0.37 uM,24 h,9,194,203,3,1,1,0,NPC
BAY-61-3606_0.37uM_24h,BAY-61-3606,0.37 uM,24 h,9,194,203,3,59,31,28,NPC
BIX-01294_0.37uM_24h,BIX-01294,0.37 uM,24 h,9,251,260,3,1,0,1,NPC
PF-03758309_0.37uM_24h,PF-03758309,0.37 uM,24 h,9,194,203,3,453,242,211,NPC
MK-1775_0.37uM_24h,MK-1775,0.37 uM,24 h,9,251,260,3,314,129,185,NPC
HMN-214_0.37uM_24h,HMN-214,0.37 uM,24 h,9,194,203,3,173,75,98,NPC
GW-5074_0.37uM_24h,GW-5074,0.37 uM,24 h,9,194,203,3,1,1,0,NPC
mocetinostat_0.37uM_24h,mocetinostat,0.37 uM,24 h,9,251,260,3,438,217,221,NPC
ABT-737_0.37uM_24h,ABT-737,0.37 uM,24 h,9,251,260,3,9,4,5,NPC
D-4476_0.37uM_24h,D-4476,0.37 uM,24 h,9,194,203,3,13,6,7,NPC
JW-55_0.37uM_24h,JW-55,0.37 uM,24 h,9,251,260,3,15,6,9,NPC
daminozide_0.37uM_24h,daminozide,0.37 uM,24 h,9,251,260,3,0,0,0,NPC
GSK-J1_0.37uM_24h,GSK-J1,0.37 uM,24 h,9,251,260,3,2,0,2,NPC
PF-573228_0.37uM_24h,PF-573228,0.37 uM,24 h,9,194,203,3,3,1,2,NPC
GSK-J2_0.37uM_24h,GSK-J2,0.37 uM,24 h,9,251,260,3,16,7,9,NPC
rucaparib_0.37uM_24h,rucaparib,0.37 uM,24 h,9,251,260,3,9,5,4,NPC
pyrazolanthrone_0.37uM_24h,pyrazolanthrone,0.37 uM,24 h,9,194,203,3,0,0,0,NPC
A-769662_0.37uM_24h,A-769662,0.37 uM,24 h,9,194,203,3,1,1,0,NPC
ZM-447439_0.37uM_24h,ZM-447439,0.37 uM,24 h,9,194,203,3,18,11,7,NPC
GSK-J4_0.37uM_24h,GSK-J4,0.37 uM,24 h,9,251,260,3,0,0,0,NPC
serdemetan_0.37uM_24h,serdemetan,0.37 uM,24 h,9,194,203,3,4,2,2,NPC
iniparib_0.37uM_24h,iniparib,0.37 uM,24 h,9,251,260,3,4,0,4,NPC
KU-60019_0.37uM_24h,KU-60019,0.37 uM,24 h,9,251,260,3,15,12,3,NPC
KI-20227_0.37uM_24h,KI-20227,0.37 uM,24 h,9,194,203,3,1,1,0,NPC
SB-239063_0.37uM_24h,SB-239063,0.37 uM,24 h,9,194,203,3,0,0,0,NPC
GDC-0879_0.37uM_24h,GDC-0879,0.37 uM,24 h,9,194,203,3,7,4,3,NPC
ACY-1215_0.37uM_24h,ACY-1215,0.37 uM,24 h,9,251,260,3,77,41,36,NPC
PFI-1_0.37uM_24h,PFI-1,0.37 uM,24 h,9,251,260,3,13,8,5,NPC
CC-401_0.37uM_24h,CC-401,0.37 uM,24 h,9,194,203,3,2,1,1,NPC
NVP-BHG712_0.37uM_24h,NVP-BHG712,0.37 uM,24 h,9,194,203,3,1,0,1,NPC
entinostat_0.37uM_24h,entinostat,0.37 uM,24 h,9,251,260,3,256,144,112,NPC
SB-939_0.37uM_24h,SB-939,0.37 uM,24 h,9,251,260,3,451,219,232,NPC
VX-745_0.37uM_24h,VX-745,0.37 uM,24 h,9,194,203,3,0,0,0,NPC
saracatinib_0.37uM_24h,saracatinib,0.37 uM,24 h,9,194,203,3,39,16,23,NPC
IOX2_0.37uM_24h,IOX2,0.37 uM,24 h,9,251,260,3,1,0,1,NPC
EX-527_0.37uM_24h,EX-527,0.37 uM,24 h,9,251,260,3,7,3,4,NPC
MGCD-265_0.37uM_24h,MGCD-265,0.37 uM,24 h,9,194,203,3,2,2,0,NPC
VE-821_0.37uM_24h,VE-821,0.37 uM,24 h,9,251,260,3,4,2,2,NPC
MC1568_0.37uM_24h,MC1568,0.37 uM,24 h,9,251,260,3,3,1,2,NPC
rigosertib_0.37uM_24h,rigosertib,0.37 uM,24 h,9,194,203,3,311,120,191,NPC
GNF-2_0.37uM_24h,GNF-2,0.37 uM,24 h,9,194,203,3,1,1,0,NPC
CX-5461_0.37uM_24h,CX-5461,0.37 uM,24 h,9,251,260,3,66,37,29,NPC
EX-527_1.11uM_24h,EX-527,1.11 uM,24 h,9,251,260,3,8,5,3,NPC
MC1568_1.11uM_24h,MC1568,1.11 uM,24 h,9,251,260,3,6,1,5,NPC
HMN-214_1.11uM_24h,HMN-214,1.11 uM,24 h,9,194,203,3,206,75,131,NPC
CC-401_1.11uM_24h,CC-401,1.11 uM,24 h,9,194,203,3,11,8,3,NPC
NVP-BHG712_1.11uM_24h,NVP-BHG712,1.11 uM,24 h,9,194,203,3,2,1,1,NPC
rucaparib_1.11uM_24h,rucaparib,1.11 uM,24 h,9,251,260,3,7,6,1,NPC
ABT-737_1.11uM_24h,ABT-737,1.11 uM,24 h,9,251,260,3,7,5,2,NPC
iniparib_1.11uM_24h,iniparib,1.11 uM,24 h,9,251,260,3,3,1,2,NPC
CX-5461_1.11uM_24h,CX-5461,1.11 uM,24 h,9,251,260,3,39,22,17,NPC
MGCD-265_1.11uM_24h,MGCD-265,1.11 uM,24 h,9,194,203,3,2,0,2,NPC
ACY-1215_1.11uM_24h,ACY-1215,1.11 uM,24 h,9,251,260,3,150,112,38,NPC
mocetinostat_1.11uM_24h,mocetinostat,1.11 uM,24 h,9,251,260,3,531,248,283,NPC
BAY-61-3606_1.11uM_24h,BAY-61-3606,1.11 uM,24 h,9,194,203,3,59,42,17,NPC
ZM-447439_1.11uM_24h,ZM-447439,1.11 uM,24 h,9,194,203,3,32,24,8,NPC
BX-795_1.11uM_24h,BX-795,1.11 uM,24 h,9,194,203,3,1,1,0,NPC
serdemetan_1.11uM_24h,serdemetan,1.11 uM,24 h,9,194,203,3,0,0,0,NPC
NU-7026_1.11uM_24h,NU-7026,1.11 uM,24 h,9,251,260,3,6,4,2,NPC
GSK-J4_1.11uM_24h,GSK-J4,1.11 uM,24 h,9,251,260,3,1,1,0,NPC
SB-203580_1.11uM_24h,SB-203580,1.11 uM,24 h,9,194,203,3,1,1,0,NPC
A-769662_1.11uM_24h,A-769662,1.11 uM,24 h,9,194,203,3,2,2,0,NPC
PFI-1_1.11uM_24h,PFI-1,1.11 uM,24 h,9,251,260,3,50,31,19,NPC
Y-27632_1.11uM_24h,Y-27632,1.11 uM,24 h,9,251,260,3,9,4,5,NPC
KI-20227_1.11uM_24h,KI-20227,1.11 uM,24 h,9,194,203,3,3,1,2,NPC
KU-60019_1.11uM_24h,KU-60019,1.11 uM,24 h,9,251,260,3,7,5,2,NPC
entinostat_1.11uM_24h,entinostat,1.11 uM,24 h,9,251,260,3,385,176,209,NPC
GSK-J1_1.11uM_24h,GSK-J1,1.11 uM,24 h,9,251,260,3,1,1,0,NPC
CGK-733_1.11uM_24h,CGK-733,1.11 uM,24 h,9,251,260,3,15,11,4,NPC
SB-939_1.11uM_24h,SB-939,1.11 uM,24 h,9,251,260,3,533,285,248,NPC
I-BET-762_1.11uM_24h,I-BET-762,1.11 uM,24 h,9,251,260,3,223,138,85,NPC
IOX2_1.11uM_24h,IOX2,1.11 uM,24 h,9,251,260,3,1,1,0,NPC
VE-821_1.11uM_24h,VE-821,1.11 uM,24 h,9,251,260,3,1,0,1,NPC
VX-745_1.11uM_24h,VX-745,1.11 uM,24 h,9,194,203,3,3,2,1,NPC
MK-1775_1.11uM_24h,MK-1775,1.11 uM,24 h,9,251,260,3,591,198,393,NPC
BI-2536_1.11uM_24h,BI-2536,1.11 uM,24 h,9,194,203,3,30,18,12,NPC
KU-55933_1.11uM_24h,KU-55933,1.11 uM,24 h,9,251,260,3,3,1,2,NPC
pyrazolanthrone_1.11uM_24h,pyrazolanthrone,1.11 uM,24 h,9,194,203,3,3,1,2,NPC
GSK-J2_1.11uM_24h,GSK-J2,1.11 uM,24 h,9,251,260,3,63,36,27,NPC
daminozide_1.11uM_24h,daminozide,1.11 uM,24 h,9,251,260,3,0,0,0,NPC
JW-55_1.11uM_24h,JW-55,1.11 uM,24 h,9,251,260,3,5,2,3,NPC
PF-573228_1.11uM_24h,PF-573228,1.11 uM,24 h,9,194,203,3,12,8,4,NPC
GNF-2_1.11uM_24h,GNF-2,1.11 uM,24 h,9,194,203,3,0,0,0,NPC
GDC-0879_1.11uM_24h,GDC-0879,1.11 uM,24 h,9,194,203,3,7,5,2,NPC
SB-239063_1.11uM_24h,SB-239063,1.11 uM,24 h,9,194,203,3,3,2,1,NPC
PF-03758309_1.11uM_24h,PF-03758309,1.11 uM,24 h,9,194,203,3,534,223,311,NPC
BIX-01294_1.11uM_24h,BIX-01294,1.11 uM,24 h,9,251,260,3,13,9,4,NPC
KI-20227_3.33uM_24h,KI-20227,3.33 uM,24 h,9,194,203,3,9,8,1,NPC
pyrazolanthrone_3.33uM_24h,pyrazolanthrone,3.33 uM,24 h,9,194,203,3,3,1,2,NPC
GSK-J4_3.33uM_24h,GSK-J4,3.33 uM,24 h,9,251,260,3,3,2,1,NPC
GDC-0879_3.33uM_24h,GDC-0879,3.33 uM,24 h,9,194,203,3,5,4,1,NPC
I-BET-762_3.33uM_24h,I-BET-762,3.33 uM,24 h,9,251,260,3,269,147,122,NPC
BX-795_3.33uM_24h,BX-795,3.33 uM,24 h,9,194,203,3,24,21,3,NPC
D-4476_3.33uM_24h,D-4476,3.33 uM,24 h,9,194,203,3,1,1,0,NPC
MK-1775_3.33uM_24h,MK-1775,3.33 uM,24 h,9,251,260,3,647,218,429,NPC
SB-203580_3.33uM_24h,SB-203580,3.33 uM,24 h,9,194,203,3,9,6,3,NPC
SB-939_3.33uM_24h,SB-939,3.33 uM,24 h,9,251,260,3,591,289,302,NPC
BIX-01294_3.33uM_24h,BIX-01294,3.33 uM,24 h,9,251,260,3,7,4,3,NPC
ABT-737_3.33uM_24h,ABT-737,3.33 uM,24 h,9,251,260,3,10,8,2,NPC
rucaparib_3.33uM_24h,rucaparib,3.33 uM,24 h,9,251,260,3,13,12,1,NPC
TAK-715_3.33uM_24h,TAK-715,3.33 uM,24 h,9,194,203,3,21,17,4,NPC
SB-239063_3.33uM_24h,SB-239063,3.33 uM,24 h,9,194,203,3,2,2,0,NPC
PFI-1_3.33uM_24h,PFI-1,3.33 uM,24 h,9,251,260,3,182,129,53,NPC
HMN-214_3.33uM_24h,HMN-214,3.33 uM,24 h,9,194,203,3,426,173,253,NPC
IOX2_3.33uM_24h,IOX2,3.33 uM,24 h,9,251,260,3,14,8,6,NPC
PF-03758309_3.33uM_24h,PF-03758309,3.33 uM,24 h,9,194,203,3,609,281,328,NPC
MGCD-265_3.33uM_24h,MGCD-265,3.33 uM,24 h,9,194,203,3,6,0,6,NPC
NVP-BHG712_3.33uM_24h,NVP-BHG712,3.33 uM,24 h,9,194,203,3,35,19,16,NPC
iniparib_3.33uM_24h,iniparib,3.33 uM,24 h,9,251,260,3,6,3,3,NPC
GNF-2_3.33uM_24h,GNF-2,3.33 uM,24 h,9,194,203,3,5,3,2,NPC
rigosertib_3.33uM_24h,rigosertib,3.33 uM,24 h,9,194,203,3,425,216,209,NPC
GSK-J2_3.33uM_24h,GSK-J2,3.33 uM,24 h,9,251,260,3,0,0,0,NPC
entinostat_3.33uM_24h,entinostat,3.33 uM,24 h,9,251,260,3,451,208,243,NPC
GSK-J1_3.33uM_24h,GSK-J1,3.33 uM,24 h,9,251,260,3,1,1,0,NPC
EX-527_3.33uM_24h,EX-527,3.33 uM,24 h,9,251,260,3,2,0,2,NPC
MC1568_3.33uM_24h,MC1568,3.33 uM,24 h,9,251,260,3,1,0,1,NPC
VX-745_3.33uM_24h,VX-745,3.33 uM,24 h,9,194,203,3,15,10,5,NPC
ZM-447439_3.33uM_24h,ZM-447439,3.33 uM,24 h,9,194,203,3,45,23,22,NPC
daminozide_3.33uM_24h,daminozide,3.33 uM,24 h,9,251,260,3,0,0,0,NPC
CX-5461_3.33uM_24h,CX-5461,3.33 uM,24 h,9,251,260,3,59,36,23,NPC
JW-55_3.33uM_24h,JW-55,3.33 uM,24 h,9,251,260,3,14,9,5,NPC
CC-401_3.33uM_24h,CC-401,3.33 uM,24 h,9,194,203,3,42,24,18,NPC
ACY-1215_3.33uM_24h,ACY-1215,3.33 uM,24 h,9,251,260,3,248,144,104,NPC
Y-27632_3.33uM_24h,Y-27632,3.33 uM,24 h,9,251,260,3,5,2,3,NPC
A-769662_3.33uM_24h,A-769662,3.33 uM,24 h,9,194,203,3,1,1,0,NPC
VE-821_3.33uM_24h,VE-821,3.33 uM,24 h,9,251,260,3,39,20,19,NPC
GW-5074_3.33uM_24h,GW-5074,3.33 uM,24 h,9,194,203,3,4,2,2,NPC
JNJ-38877605_3.33uM_24h,JNJ-38877605,3.33 uM,24 h,9,194,203,3,1,0,1,NPC
mocetinostat_3.33uM_24h,mocetinostat,3.33 uM,24 h,9,251,260,3,594,269,325,NPC
BI-2536_3.33uM_24h,BI-2536,3.33 uM,24 h,9,194,203,3,36,12,24,NPC
CGK-733_3.33uM_24h,CGK-733,3.33 uM,24 h,9,251,260,3,452,203,249,NPC
NU-7026_3.33uM_24h,NU-7026,3.33 uM,24 h,9,251,260,3,5,1,4,NPC
pifithrin-mu_10uM_24h,pifithrin-mu,10 uM,24 h,8,98,106,3,3,2,1,NPC
MK-1775_10uM_24h,MK-1775,10 uM,24 h,8,223,231,3,718,248,470,NPC
RU-24969_10uM_24h,RU-24969,10 uM,24 h,8,98,106,3,0,0,0,NPC
tetradecylthioacetic-acid_10uM_24h,tetradecylthioacetic-acid,10 uM,24 h,8,76,84,3,19,1,18,NPC
GSK-J1_10uM_24h,GSK-J1,10 uM,24 h,8,224,232,3,0,0,0,NPC
L-689560_10uM_24h,L-689560,10 uM,24 h,8,79,87,2,0,0,0,NPC
CGP-60474_10uM_24h,CGP-60474,10 uM,24 h,8,148,156,5,658,243,415,NPC
VE-821_10uM_24h,VE-821,10 uM,24 h,8,224,232,3,115,49,66,NPC
MPEP_10uM_24h,MPEP,10 uM,24 h,8,98,106,3,0,0,0,NPC
PF-573228_10uM_24h,PF-573228,10 uM,24 h,8,173,181,3,128,78,50,NPC
SB-203580_0.04uM_24h,SB-203580,0.04 uM,24 h,8,172,180,3,1,1,0,NPC
JW-55_0.04uM_24h,JW-55,0.04 uM,24 h,8,224,232,3,0,0,0,NPC
CC-401_0.12uM_24h,CC-401,0.12 uM,24 h,8,172,180,3,11,5,6,NPC
SB-203580_0.12uM_24h,SB-203580,0.12 uM,24 h,8,173,181,3,17,12,5,NPC
CGK-733_0.12uM_24h,CGK-733,0.12 uM,24 h,8,223,231,3,3,2,1,NPC
HMN-214_0.12uM_24h,HMN-214,0.12 uM,24 h,8,173,181,3,126,57,69,NPC
SB-939_0.12uM_24h,SB-939,0.12 uM,24 h,8,223,231,3,351,191,160,NPC
NU-7026_0.37uM_24h,NU-7026,0.37 uM,24 h,8,223,231,3,41,10,31,NPC
SB-203580_0.37uM_24h,SB-203580,0.37 uM,24 h,8,172,180,3,4,3,1,NPC
JNJ-38877605_0.37uM_24h,JNJ-38877605,0.37 uM,24 h,8,172,180,3,86,42,44,NPC
rigosertib_1.11uM_24h,rigosertib,1.11 uM,24 h,8,172,180,3,357,155,202,NPC
saracatinib_1.11uM_24h,saracatinib,1.11 uM,24 h,8,173,181,3,119,65,54,NPC
GW-5074_1.11uM_24h,GW-5074,1.11 uM,24 h,8,172,180,3,1,0,1,NPC
JNJ-38877605_1.11uM_24h,JNJ-38877605,1.11 uM,24 h,8,172,180,3,0,0,0,NPC
TAK-715_1.11uM_24h,TAK-715,1.11 uM,24 h,8,173,181,3,1,1,0,NPC
D-4476_1.11uM_24h,D-4476,1.11 uM,24 h,8,173,181,3,4,1,3,NPC
serdemetan_3.33uM_24h,serdemetan,3.33 uM,24 h,8,173,181,3,11,9,2,NPC
PF-573228_3.33uM_24h,PF-573228,3.33 uM,24 h,8,172,180,3,8,4,4,NPC
KU-60019_3.33uM_24h,KU-60019,3.33 uM,24 h,8,223,231,3,338,129,209,NPC
KU-55933_3.33uM_24h,KU-55933,3.33 uM,24 h,8,223,231,3,1,1,0,NPC
BAY-61-3606_3.33uM_24h,BAY-61-3606,3.33 uM,24 h,8,173,181,3,193,92,101,NPC
CS-110266_10uM_24h,CS-110266,10 uM,24 h,7,87,94,3,66,33,33,NPC
KW-2449_10uM_24h,KW-2449,10 uM,24 h,7,153,160,3,476,188,288,NPC
BMS-777607_10uM_24h,BMS-777607,10 uM,24 h,7,153,160,3,50,34,16,NPC
NVP-TAE684_10uM_24h,NVP-TAE684,10 uM,24 h,7,45,52,2,376,147,229,NPC
GW-441756_10uM_24h,GW-441756,10 uM,24 h,7,69,76,2,2,1,1,NPC
FR-180204_10uM_24h,FR-180204,10 uM,24 h,7,153,160,3,13,7,6,NPC
PF-04217903_10uM_24h,PF-04217903,10 uM,24 h,7,153,160,3,3,2,1,NPC
GBR-12783_10uM_24h,GBR-12783,10 uM,24 h,7,72,79,2,1,0,1,NPC
AST-1306_10uM_24h,AST-1306,10 uM,24 h,7,153,160,3,142,41,101,NPC
cyclopamine_10uM_24h,cyclopamine,10 uM,24 h,7,66,73,2,8,1,7,NPC
tivantinib_10uM_24h,tivantinib,10 uM,24 h,7,153,160,3,322,129,193,NPC
fenretinide_10uM_24h,fenretinide,10 uM,24 h,7,60,67,2,489,200,289,NPC
amuvatinib_10uM_24h,amuvatinib,10 uM,24 h,7,153,160,3,442,172,270,NPC
GDC-0068_10uM_24h,GDC-0068,10 uM,24 h,7,153,160,3,381,151,230,NPC
TPCA-1_10uM_24h,TPCA-1,10 uM,24 h,7,153,160,3,423,134,289,NPC
BIX-02189_10uM_24h,BIX-02189,10 uM,24 h,7,153,160,3,126,60,66,NPC
SAR-245409_10uM_24h,SAR-245409,10 uM,24 h,7,153,160,3,8,5,3,NPC
doramapimod_10uM_24h,doramapimod,10 uM,24 h,7,153,160,3,10,5,5,NPC
AST-1306_0.04uM_24h,AST-1306,0.04 uM,24 h,7,153,160,3,4,2,2,NPC
doramapimod_0.04uM_24h,doramapimod,0.04 uM,24 h,7,153,160,3,12,6,6,NPC
GDC-0068_0.04uM_24h,GDC-0068,0.04 uM,24 h,7,153,160,3,0,0,0,NPC
motesanib_0.04uM_24h,motesanib,0.04 uM,24 h,7,153,160,3,1,1,0,NPC
PHA-767491_0.04uM_24h,PHA-767491,0.04 uM,24 h,7,153,160,3,2,2,0,NPC
PF-573228_0.04uM_24h,PF-573228,0.04 uM,24 h,7,151,158,3,0,0,0,NPC
BMS-777607_0.04uM_24h,BMS-777607,0.04 uM,24 h,7,153,160,3,0,0,0,NPC
BIX-02189_0.04uM_24h,BIX-02189,0.04 uM,24 h,7,153,160,3,7,4,3,NPC
AZ-628_0.04uM_24h,AZ-628,0.04 uM,24 h,7,153,160,3,43,21,22,NPC
quizartinib_0.04uM_24h,quizartinib,0.04 uM,24 h,7,153,160,3,72,49,23,NPC
FR-180204_0.04uM_24h,FR-180204,0.04 uM,24 h,7,153,160,3,0,0,0,NPC
BS-181_0.04uM_24h,BS-181,0.04 uM,24 h,7,153,160,3,7,4,3,NPC
PF-04217903_0.04uM_24h,PF-04217903,0.04 uM,24 h,7,153,160,3,4,3,1,NPC
WZ-4002_0.04uM_24h,WZ-4002,0.04 uM,24 h,7,153,160,3,60,42,18,NPC
OSI-930_0.04uM_24h,OSI-930,0.04 uM,24 h,7,153,160,3,1,1,0,NPC
SB-216763_0.04uM_24h,SB-216763,0.04 uM,24 h,7,153,160,3,7,5,2,NPC
SAR-245409_0.04uM_24h,SAR-245409,0.04 uM,24 h,7,153,160,3,2,2,0,NPC
NVP-TAE226_0.04uM_24h,NVP-TAE226,0.04 uM,24 h,7,153,160,3,3,1,2,NPC
amuvatinib_0.04uM_24h,amuvatinib,0.04 uM,24 h,7,153,160,3,429,131,298,NPC
tivantinib_0.04uM_24h,tivantinib,0.04 uM,24 h,7,153,160,3,113,44,69,NPC
rebastinib_0.04uM_24h,rebastinib,0.04 uM,24 h,7,153,160,3,318,129,189,NPC
motesanib_0.12uM_24h,motesanib,0.12 uM,24 h,7,153,160,3,0,0,0,NPC
BS-181_0.12uM_24h,BS-181,0.12 uM,24 h,7,153,160,3,8,6,2,NPC
AST-1306_0.12uM_24h,AST-1306,0.12 uM,24 h,7,153,160,3,3,1,2,NPC
BIX-02189_0.12uM_24h,BIX-02189,0.12 uM,24 h,7,153,160,3,5,3,2,NPC
TPCA-1_0.12uM_24h,TPCA-1,0.12 uM,24 h,7,153,160,3,119,66,53,NPC
NVP-TAE226_0.12uM_24h,NVP-TAE226,0.12 uM,24 h,7,153,160,3,113,33,80,NPC
SGI-1776_0.12uM_24h,SGI-1776,0.12 uM,24 h,7,153,160,3,1,1,0,NPC
quizartinib_0.12uM_24h,quizartinib,0.12 uM,24 h,7,153,160,3,8,5,3,NPC
SB-525334_0.12uM_24h,SB-525334,0.12 uM,24 h,7,153,160,3,0,0,0,NPC
tivantinib_0.12uM_24h,tivantinib,0.12 uM,24 h,7,153,160,3,340,112,228,NPC
PF-04217903_0.12uM_24h,PF-04217903,0.12 uM,24 h,7,153,160,3,4,2,2,NPC
rebastinib_0.12uM_24h,rebastinib,0.12 uM,24 h,7,153,160,3,240,127,113,NPC
doramapimod_0.12uM_24h,doramapimod,0.12 uM,24 h,7,153,160,3,8,5,3,NPC
SB-216763_0.12uM_24h,SB-216763,0.12 uM,24 h,7,153,160,3,5,3,2,NPC
AZ-628_0.12uM_24h,AZ-628,0.12 uM,24 h,7,153,160,3,169,78,91,NPC
amuvatinib_0.12uM_24h,amuvatinib,0.12 uM,24 h,7,153,160,3,203,88,115,NPC
NVP-BGJ398_0.12uM_24h,NVP-BGJ398,0.12 uM,24 h,7,153,160,3,109,55,54,NPC
SAR-245409_0.12uM_24h,SAR-245409,0.12 uM,24 h,7,153,160,3,4,4,0,NPC
BMS-777607_0.12uM_24h,BMS-777607,0.12 uM,24 h,7,153,160,3,2,1,1,NPC
PHA-767491_0.12uM_24h,PHA-767491,0.12 uM,24 h,7,153,160,3,16,1,15,NPC
FR-180204_0.12uM_24h,FR-180204,0.12 uM,24 h,7,153,160,3,1,1,0,NPC
KW-2449_0.12uM_24h,KW-2449,0.12 uM,24 h,7,153,160,3,5,2,3,NPC
GDC-0068_0.12uM_24h,GDC-0068,0.12 uM,24 h,7,153,160,3,6,2,4,NPC
quizartinib_0.37uM_24h,quizartinib,0.37 uM,24 h,7,153,160,3,8,5,3,NPC
TPCA-1_0.37uM_24h,TPCA-1,0.37 uM,24 h,7,153,160,3,72,46,26,NPC
SB-216763_0.37uM_24h,SB-216763,0.37 uM,24 h,7,153,160,3,2,1,1,NPC
GDC-0068_0.37uM_24h,GDC-0068,0.37 uM,24 h,7,153,160,3,18,10,8,NPC
OSI-930_0.37uM_24h,OSI-930,0.37 uM,24 h,7,153,160,3,5,3,2,NPC
SAR-245409_0.37uM_24h,SAR-245409,0.37 uM,24 h,7,153,160,3,129,59,70,NPC
BMS-777607_0.37uM_24h,BMS-777607,0.37 uM,24 h,7,153,160,3,2,1,1,NPC
NVP-BGJ398_0.37uM_24h,NVP-BGJ398,0.37 uM,24 h,7,153,160,3,439,180,259,NPC
doramapimod_0.37uM_24h,doramapimod,0.37 uM,24 h,7,153,160,3,3,2,1,NPC
FR-180204_0.37uM_24h,FR-180204,0.37 uM,24 h,7,153,160,3,1,1,0,NPC
SB-525334_0.37uM_24h,SB-525334,0.37 uM,24 h,7,153,160,3,1,0,1,NPC
NVP-TAE226_0.37uM_24h,NVP-TAE226,0.37 uM,24 h,7,153,160,3,228,104,124,NPC
AST-1306_0.37uM_24h,AST-1306,0.37 uM,24 h,7,153,160,3,7,2,5,NPC
AZ-628_0.37uM_24h,AZ-628,0.37 uM,24 h,7,153,160,3,117,71,46,NPC
KW-2449_0.37uM_24h,KW-2449,0.37 uM,24 h,7,153,160,3,8,4,4,NPC
BIX-02189_0.37uM_24h,BIX-02189,0.37 uM,24 h,7,153,160,3,3,2,1,NPC
PF-04217903_0.37uM_24h,PF-04217903,0.37 uM,24 h,7,153,160,3,3,1,2,NPC
PHA-767491_0.37uM_24h,PHA-767491,0.37 uM,24 h,7,153,160,3,34,20,14,NPC
SGI-1776_0.37uM_24h,SGI-1776,0.37 uM,24 h,7,153,160,3,1,1,0,NPC
motesanib_0.37uM_24h,motesanib,0.37 uM,24 h,7,153,160,3,2,2,0,NPC
WZ-4002_0.37uM_24h,WZ-4002,0.37 uM,24 h,7,153,160,3,0,0,0,NPC
tivantinib_0.37uM_24h,tivantinib,0.37 uM,24 h,7,153,160,3,222,96,126,NPC
rebastinib_0.37uM_24h,rebastinib,0.37 uM,24 h,7,153,160,3,246,112,134,NPC
amuvatinib_0.37uM_24h,amuvatinib,0.37 uM,24 h,7,153,160,3,10,7,3,NPC
BS-181_0.37uM_24h,BS-181,0.37 uM,24 h,7,153,160,3,1,0,1,NPC
SB-216763_1.11uM_24h,SB-216763,1.11 uM,24 h,7,153,160,3,3,1,2,NPC
KW-2449_1.11uM_24h,KW-2449,1.11 uM,24 h,7,153,160,3,27,17,10,NPC
quizartinib_1.11uM_24h,quizartinib,1.11 uM,24 h,7,153,160,3,5,0,5,NPC
PHA-767491_1.11uM_24h,PHA-767491,1.11 uM,24 h,7,153,160,3,106,51,55,NPC
SAR-245409_1.11uM_24h,SAR-245409,1.11 uM,24 h,7,153,160,3,160,44,116,NPC
FR-180204_1.11uM_24h,FR-180204,1.11 uM,24 h,7,153,160,3,0,0,0,NPC
amuvatinib_1.11uM_24h,amuvatinib,1.11 uM,24 h,7,153,160,3,250,125,125,NPC
rebastinib_1.11uM_24h,rebastinib,1.11 uM,24 h,7,153,160,3,450,153,297,NPC
BMS-777607_1.11uM_24h,BMS-777607,1.11 uM,24 h,7,153,160,3,0,0,0,NPC
BS-181_1.11uM_24h,BS-181,1.11 uM,24 h,7,153,160,3,9,5,4,NPC
TPCA-1_1.11uM_24h,TPCA-1,1.11 uM,24 h,7,153,160,3,203,101,102,NPC
tivantinib_1.11uM_24h,tivantinib,1.11 uM,24 h,7,153,160,3,533,164,369,NPC
AST-1306_1.11uM_24h,AST-1306,1.11 uM,24 h,7,153,160,3,23,9,14,NPC
SGI-1776_1.11uM_24h,SGI-1776,1.11 uM,24 h,7,153,160,3,4,3,1,NPC
motesanib_1.11uM_24h,motesanib,1.11 uM,24 h,7,153,160,3,2,1,1,NPC
doramapimod_1.11uM_24h,doramapimod,1.11 uM,24 h,7,153,160,3,2,2,0,NPC
WZ-4002_1.11uM_24h,WZ-4002,1.11 uM,24 h,7,153,160,3,14,5,9,NPC
AZ-628_1.11uM_24h,AZ-628,1.11 uM,24 h,7,153,160,3,124,70,54,NPC
NVP-BGJ398_1.11uM_24h,NVP-BGJ398,1.11 uM,24 h,7,153,160,3,415,162,253,NPC
PF-04217903_1.11uM_24h,PF-04217903,1.11 uM,24 h,7,153,160,3,1,0,1,NPC
NVP-TAE226_1.11uM_24h,NVP-TAE226,1.11 uM,24 h,7,153,160,3,389,156,233,NPC
OSI-930_1.11uM_24h,OSI-930,1.11 uM,24 h,7,153,160,3,1,0,1,NPC
SB-525334_1.11uM_24h,SB-525334,1.11 uM,24 h,7,153,160,3,2,2,0,NPC
GDC-0068_1.11uM_24h,GDC-0068,1.11 uM,24 h,7,153,160,3,96,43,53,NPC
BIX-02189_1.11uM_24h,BIX-02189,1.11 uM,24 h,7,153,160,3,4,1,3,NPC
KW-2449_3.33uM_24h,KW-2449,3.33 uM,24 h,7,153,160,3,47,31,16,NPC
doramapimod_3.33uM_24h,doramapimod,3.33 uM,24 h,7,153,160,3,1,0,1,NPC
PF-04217903_3.33uM_24h,PF-04217903,3.33 uM,24 h,7,153,160,3,7,6,1,NPC
PHA-767491_3.33uM_24h,PHA-767491,3.33 uM,24 h,7,153,160,3,502,240,262,NPC
amuvatinib_3.33uM_24h,amuvatinib,3.33 uM,24 h,7,153,160,3,74,49,25,NPC
NVP-TAE226_3.33uM_24h,NVP-TAE226,3.33 uM,24 h,7,153,160,3,448,179,269,NPC
AST-1306_3.33uM_24h,AST-1306,3.33 uM,24 h,7,153,160,3,63,26,37,NPC
TPCA-1_3.33uM_24h,TPCA-1,3.33 uM,24 h,7,153,160,3,59,40,19,NPC
SB-216763_3.33uM_24h,SB-216763,3.33 uM,24 h,7,153,160,3,14,3,11,NPC
FR-180204_3.33uM_24h,FR-180204,3.33 uM,24 h,7,153,160,3,3,1,2,NPC
OSI-930_3.33uM_24h,OSI-930,3.33 uM,24 h,7,153,160,3,16,6,10,NPC
motesanib_3.33uM_24h,motesanib,3.33 uM,24 h,7,153,160,3,2,1,1,NPC
saracatinib_3.33uM_24h,saracatinib,3.33 uM,24 h,7,150,157,3,572,224,348,NPC
NVP-BGJ398_3.33uM_24h,NVP-BGJ398,3.33 uM,24 h,7,153,160,3,462,174,288,NPC
AZ-628_3.33uM_24h,AZ-628,3.33 uM,24 h,7,153,160,3,146,72,74,NPC
GDC-0068_3.33uM_24h,GDC-0068,3.33 uM,24 h,7,153,160,3,288,111,177,NPC
rebastinib_3.33uM_24h,rebastinib,3.33 uM,24 h,7,153,160,3,315,135,180,NPC
SB-525334_3.33uM_24h,SB-525334,3.33 uM,24 h,7,153,160,3,4,3,1,NPC
BMS-777607_3.33uM_24h,BMS-777607,3.33 uM,24 h,7,153,160,3,4,3,1,NPC
SAR-245409_3.33uM_24h,SAR-245409,3.33 uM,24 h,7,153,160,3,2,2,0,NPC
WZ-4002_3.33uM_24h,WZ-4002,3.33 uM,24 h,7,153,160,3,54,26,28,NPC
SGI-1776_3.33uM_24h,SGI-1776,3.33 uM,24 h,7,153,160,3,203,91,112,NPC
quizartinib_3.33uM_24h,quizartinib,3.33 uM,24 h,7,153,160,3,28,6,22,NPC
spermidine_10uM_24h,spermidine,10 uM,24 h,6,58,64,2,0,0,0,NPC
AM-580_10uM_6h,AM-580,10 uM,6 h,6,55,61,2,1,0,1,NPC
tomelukast_10uM_6h,tomelukast,10 uM,6 h,6,55,61,2,0,0,0,NPC
CITCO_10uM_6h,CITCO,10 uM,6 h,6,55,61,2,0,0,0,NPC
tetradecylthioacetic-acid_10uM_6h,tetradecylthioacetic-acid,10 uM,6 h,6,55,61,2,0,0,0,NPC
OSI-930_10uM_24h,OSI-930,10 uM,24 h,6,131,137,3,98,41,57,NPC
anisomycin_10uM_6h,anisomycin,10 uM,6 h,6,55,61,2,274,108,166,NPC
PNU-74654_10uM_6h,PNU-74654,10 uM,6 h,6,55,61,2,0,0,0,NPC
anandamide_10uM_6h,anandamide,10 uM,6 h,6,55,61,2,1,1,0,NPC
zebularine_10uM_24h,zebularine,10 uM,24 h,6,58,64,2,20,2,18,NPC
PCI-34051_10uM_24h,PCI-34051,10 uM,24 h,6,58,64,2,65,21,44,NPC
exifone_10uM_24h,exifone,10 uM,24 h,6,58,64,2,133,27,106,NPC
foxy-5_10uM_6h,foxy-5,10 uM,6 h,6,55,61,2,4,2,2,NPC
NCS-382_10uM_24h,NCS-382,10 uM,24 h,6,32,38,1,0,0,0,NPC
NVP-BEZ235_10uM_24h,NVP-BEZ235,10 uM,24 h,6,58,64,2,347,110,237,NPC
tomelukast_10uM_24h,tomelukast,10 uM,24 h,6,58,64,2,0,0,0,NPC
NSC-3852_10uM_6h,NSC-3852,10 uM,6 h,6,55,61,2,111,46,65,NPC
SMER-28_10uM_24h,SMER-28,10 uM,24 h,6,58,64,2,85,13,72,NPC
NVP-BEZ235_10uM_6h,NVP-BEZ235,10 uM,6 h,6,55,61,2,47,11,36,NPC
ellagic-acid_10uM_24h,ellagic-acid,10 uM,24 h,6,58,64,2,5,2,3,NPC
dinoprostone_10uM_6h,dinoprostone,10 uM,6 h,6,55,61,2,4,2,2,NPC
M-344_10uM_24h,M-344,10 uM,24 h,6,58,64,2,498,246,252,NPC
FH-535_10uM_24h,FH-535,10 uM,24 h,6,58,64,2,2,1,1,NPC
PNU-74654_10uM_24h,PNU-74654,10 uM,24 h,6,58,64,2,1,1,0,NPC
PI-103_10uM_6h,PI-103,10 uM,6 h,6,55,61,2,95,31,64,NPC
TWS-119_10uM_6h,TWS-119,10 uM,6 h,6,55,61,2,19,6,13,NPC
pyrazolanthrone_10uM_6h,pyrazolanthrone,10 uM,6 h,6,55,61,2,6,2,4,NPC
plumbagin_10uM_6h,plumbagin,10 uM,6 h,6,55,61,2,488,161,327,NPC
MG-132_10uM_6h,MG-132,10 uM,6 h,6,55,61,2,131,46,85,NPC
PI-103_10uM_24h,PI-103,10 uM,24 h,6,58,64,2,438,140,298,NPC
ellagic-acid_10uM_6h,ellagic-acid,10 uM,6 h,6,55,61,2,23,5,18,NPC
NO-ASA_10uM_6h,NO-ASA,10 uM,6 h,6,55,61,2,112,51,61,NPC
SMER-28_10uM_6h,SMER-28,10 uM,6 h,6,55,61,2,1,1,0,NPC
foxy-5_10uM_24h,foxy-5,10 uM,24 h,6,58,64,2,0,0,0,NPC
PP-2_10uM_6h,PP-2,10 uM,6 h,6,55,61,2,98,43,55,NPC
BML-284_10uM_24h,BML-284,10 uM,24 h,6,58,64,2,331,117,214,NPC
gallic-acid_10uM_6h,gallic-acid,10 uM,6 h,6,55,61,2,13,12,1,NPC
L-690330_10uM_6h,L-690330,10 uM,6 h,6,55,61,2,0,0,0,NPC
enzastaurin_10uM_24h,enzastaurin,10 uM,24 h,6,29,35,1,0,0,0,NPC
CP-724714_10uM_24h,CP-724714,10 uM,24 h,6,27,33,1,0,0,0,NPC
TNP-470_10uM_24h,TNP-470,10 uM,24 h,6,58,64,2,82,23,59,NPC
BADGE_10uM_6h,BADGE,10 uM,6 h,6,55,61,2,1,0,1,NPC
SB-202190_10uM_6h,SB-202190,10 uM,6 h,6,55,61,2,0,0,0,NPC
dacinostat_10uM_24h,dacinostat,10 uM,24 h,6,29,35,1,12,6,6,NPC
rosiglitazone_10uM_6h,rosiglitazone,10 uM,6 h,6,55,61,2,0,0,0,NPC
ABC-294640_10uM_24h,ABC-294640,10 uM,24 h,6,58,64,2,5,4,1,NPC
STF-62247_10uM_6h,STF-62247,10 uM,6 h,6,55,61,2,1,1,0,NPC
FH-535_10uM_6h,FH-535,10 uM,6 h,6,55,61,2,0,0,0,NPC
rebastinib_10uM_24h,rebastinib,10 uM,24 h,6,131,137,3,781,298,483,NPC
L-690330_10uM_24h,L-690330,10 uM,24 h,6,58,64,2,0,0,0,NPC
GDC-0941_10uM_24h,GDC-0941,10 uM,24 h,6,29,35,1,126,37,89,NPC
NVP-BGJ398_10uM_24h,NVP-BGJ398,10 uM,24 h,6,132,138,3,500,186,314,NPC
gallic-acid_10uM_24h,gallic-acid,10 uM,24 h,6,58,64,2,170,50,120,NPC
piceatannol_10uM_6h,piceatannol,10 uM,6 h,6,55,61,2,45,35,10,NPC
PD-98059_10uM_6h,PD-98059,10 uM,6 h,6,55,61,2,0,0,0,NPC
barasertib-HQPA_10uM_24h,barasertib-HQPA,10 uM,24 h,6,56,62,2,32,11,21,NPC
D-4476_10uM_6h,D-4476,10 uM,6 h,6,55,61,2,1,0,1,NPC
parthenolide_10uM_24h,parthenolide,10 uM,24 h,6,59,65,2,212,84,128,NPC
ZSTK-474_10uM_24h,ZSTK-474,10 uM,24 h,6,56,62,2,142,45,97,NPC
scriptaid_10uM_6h,scriptaid,10 uM,6 h,6,55,61,2,174,103,71,NPC
PCI-34051_10uM_6h,PCI-34051,10 uM,6 h,6,55,61,2,1,0,1,NPC
kenpaullone_10uM_6h,kenpaullone,10 uM,6 h,6,55,61,2,16,6,10,NPC
zebularine_10uM_6h,zebularine,10 uM,6 h,6,55,61,2,1,0,1,NPC
pterostilbene_10uM_24h,pterostilbene,10 uM,24 h,6,58,64,2,27,11,16,NPC
pterostilbene_10uM_6h,pterostilbene,10 uM,6 h,6,55,61,2,3,1,2,NPC
tanespimycin_10uM_6h,tanespimycin,10 uM,6 h,6,55,61,2,120,53,67,NPC
apigenin_10uM_6h,apigenin,10 uM,6 h,6,55,61,2,22,10,12,NPC
pirinixic-acid_10uM_6h,pirinixic-acid,10 uM,6 h,6,55,61,2,0,0,0,NPC
AG-490_10uM_24h,AG-490,10 uM,24 h,6,32,38,1,1,1,0,NPC
BML-284_10uM_6h,BML-284,10 uM,6 h,6,55,61,2,163,52,111,NPC
CITCO_10uM_24h,CITCO,10 uM,24 h,6,58,64,2,0,0,0,NPC
PD-184352_10uM_24h,PD-184352,10 uM,24 h,6,56,62,2,73,34,39,NPC
TTNPB_10uM_6h,TTNPB,10 uM,6 h,6,55,61,2,1,0,1,NPC
spermidine_10uM_6h,spermidine,10 uM,6 h,6,55,61,2,1,0,1,NPC
GW-4064_10uM_6h,GW-4064,10 uM,6 h,6,55,61,2,1,1,0,NPC
GW-7647_10uM_6h,GW-7647,10 uM,6 h,6,55,61,2,10,7,3,NPC
STF-62247_10uM_24h,STF-62247,10 uM,24 h,6,58,64,2,47,22,25,NPC
suloctidil_10uM_24h,suloctidil,10 uM,24 h,6,37,43,1,6,2,4,NPC
acadesine_10uM_6h,acadesine,10 uM,6 h,6,55,61,2,2,1,1,NPC
AR-A014418_10uM_6h,AR-A014418,10 uM,6 h,6,55,61,2,1,1,0,NPC
endo-IWR-1_10uM_6h,endo-IWR-1,10 uM,6 h,6,55,61,2,2,0,2,NPC
endo-IWR-1_10uM_24h,endo-IWR-1,10 uM,24 h,6,58,64,2,127,43,84,NPC
TNP-470_10uM_6h,TNP-470,10 uM,6 h,6,55,61,2,11,8,3,NPC
ABC-294640_10uM_6h,ABC-294640,10 uM,6 h,6,55,61,2,0,0,0,NPC
NO-ASA_10uM_24h,NO-ASA,10 uM,24 h,6,58,64,2,75,20,55,NPC
tozasertib_10uM_24h,tozasertib,10 uM,24 h,6,27,33,1,559,211,348,NPC
ciglitazone_10uM_6h,ciglitazone,10 uM,6 h,6,55,61,2,0,0,0,NPC
M-344_10uM_6h,M-344,10 uM,6 h,6,55,61,2,170,80,90,NPC
genistein_10uM_6h,genistein,10 uM,6 h,6,55,61,2,1,0,1,NPC
KW-2449_0.04uM_24h,KW-2449,0.04 uM,24 h,6,131,137,3,8,5,3,NPC
SB-525334_0.04uM_24h,SB-525334,0.04 uM,24 h,6,131,137,3,1,0,1,NPC
SGI-1776_0.04uM_24h,SGI-1776,0.04 uM,24 h,6,131,137,3,2,1,1,NPC
WZ-4002_0.12uM_24h,WZ-4002,0.12 uM,24 h,6,131,137,3,2,2,0,NPC
OSI-930_0.12uM_24h,OSI-930,0.12 uM,24 h,6,131,137,3,5,1,4,NPC
CGP-60474_0.37uM_24h,CGP-60474,0.37 uM,24 h,6,136,142,4,797,305,492,NPC
geldanamycin_0.37uM_24h,geldanamycin,0.37 uM,24 h,6,99,105,2,38,25,13,NPC
wortmannin_0.37uM_24h,wortmannin,0.37 uM,24 h,6,99,105,2,0,0,0,NPC
geldanamycin_1.11uM_24h,geldanamycin,1.11 uM,24 h,6,99,105,2,193,75,118,NPC
troglitazone_1.11uM_24h,troglitazone,1.11 uM,24 h,6,99,105,2,2,1,1,NPC
wortmannin_1.11uM_24h,wortmannin,1.11 uM,24 h,6,99,105,2,4,1,3,NPC
BS-181_3.33uM_24h,BS-181,3.33 uM,24 h,6,131,137,3,133,68,65,NPC
geldanamycin_3.33uM_24h,geldanamycin,3.33 uM,24 h,6,99,105,2,414,153,261,NPC
wortmannin_3.33uM_24h,wortmannin,3.33 uM,24 h,6,99,105,2,1,1,0,NPC
tivantinib_3.33uM_24h,tivantinib,3.33 uM,24 h,6,132,138,3,280,109,171,NPC
BIX-02189_3.33uM_24h,BIX-02189,3.33 uM,24 h,6,131,137,3,7,4,3,NPC
octopamine_10uM_24h,octopamine,10 uM,24 h,5,66,71,2,0,0,0,NPC
WZ-4002_10uM_24h,WZ-4002,10 uM,24 h,5,72,77,2,292,84,208,NPC
MPEP_10uM_6h,MPEP,10 uM,6 h,5,54,59,2,1,0,1,NPC
octopamine_10uM_6h,octopamine,10 uM,6 h,5,54,59,2,0,0,0,NPC
GGTI-298_10uM_24h,GGTI-298,10 uM,24 h,5,66,71,2,1,1,0,NPC
GGTI-298_10uM_6h,GGTI-298,10 uM,6 h,5,54,59,2,1,1,0,NPC
kaempferol_10uM_24h,kaempferol,10 uM,24 h,5,66,71,2,0,0,0,NPC
phenothiazine_10uM_6h,phenothiazine,10 uM,6 h,5,54,59,2,0,0,0,NPC
nocodazole_10uM_6h,nocodazole,10 uM,6 h,5,54,59,2,92,58,34,NPC
CGS-21680_10uM_6h,CGS-21680,10 uM,6 h,5,54,59,2,0,0,0,NPC
mevastatin_10uM_6h,mevastatin,10 uM,6 h,5,54,59,2,2,1,1,NPC
ciproxifan_10uM_24h,ciproxifan,10 uM,24 h,5,66,71,2,3,2,1,NPC
alpha-methylserotonin_10uM_24h,alpha-methylserotonin,10 uM,24 h,5,66,71,2,2,1,1,NPC
phenothiazine_10uM_24h,phenothiazine,10 uM,24 h,5,66,71,2,0,0,0,NPC
ciproxifan_10uM_6h,ciproxifan,10 uM,6 h,5,54,59,2,0,0,0,NPC
SKF-81297_10uM_6h,SKF-81297,10 uM,6 h,5,54,59,2,0,0,0,NPC
SIB-1553A_10uM_6h,SIB-1553A,10 uM,6 h,5,54,59,2,0,0,0,NPC
rimonabant_10uM_24h,rimonabant,10 uM,24 h,5,66,71,2,0,0,0,NPC
WAY-100635_10uM_6h,WAY-100635,10 uM,6 h,5,54,59,2,0,0,0,NPC
luzindole_10uM_6h,luzindole,10 uM,6 h,5,54,59,2,0,0,0,NPC
clorgiline_10uM_6h,clorgiline,10 uM,6 h,5,54,59,2,0,0,0,NPC
kaempferol_10uM_6h,kaempferol,10 uM,6 h,5,54,59,2,0,0,0,NPC
SIB-1553A_10uM_24h,SIB-1553A,10 uM,24 h,5,66,71,2,0,0,0,NPC
cyanopindolol_10uM_6h,cyanopindolol,10 uM,6 h,5,54,59,2,2,2,0,NPC
nisoxetine_10uM_6h,nisoxetine,10 uM,6 h,5,54,59,2,0,0,0,NPC
oxyphenbutazone_10uM_6h,oxyphenbutazone,10 uM,6 h,5,54,59,2,72,37,35,NPC
thioperamide_10uM_6h,thioperamide,10 uM,6 h,5,54,59,2,0,0,0,NPC
nisoxetine_10uM_24h,nisoxetine,10 uM,24 h,5,66,71,2,1,1,0,NPC
pifithrin-mu_10uM_6h,pifithrin-mu,10 uM,6 h,5,54,59,2,47,25,22,NPC
rimonabant_10uM_6h,rimonabant,10 uM,6 h,5,54,59,2,4,1,3,NPC
alpha-methylserotonin_10uM_6h,alpha-methylserotonin,10 uM,6 h,5,54,59,2,10,3,7,NPC
tolcapone_10uM_24h,tolcapone,10 uM,24 h,5,66,71,2,0,0,0,NPC
zacopride_10uM_6h,zacopride,10 uM,6 h,5,54,59,2,0,0,0,NPC
PD-173074_10uM_24h,PD-173074,10 uM,24 h,5,48,53,2,500,196,304,NPC
zacopride_10uM_24h,zacopride,10 uM,24 h,5,66,71,2,0,0,0,NPC
tolcapone_10uM_6h,tolcapone,10 uM,6 h,5,54,59,2,0,0,0,NPC
NVP-TAE226_10uM_24h,NVP-TAE226,10 uM,24 h,5,109,114,3,577,213,364,NPC
cyanopindolol_10uM_24h,cyanopindolol,10 uM,24 h,5,66,71,2,2,1,1,NPC
RU-24969_10uM_6h,RU-24969,10 uM,6 h,5,54,59,2,0,0,0,NPC
CS-110266_10uM_6h,CS-110266,10 uM,6 h,5,54,59,2,5,4,1,NPC
fenobam_10uM_6h,fenobam,10 uM,6 h,5,54,59,2,0,0,0,NPC
YM-298198_10uM_6h,YM-298198,10 uM,6 h,5,54,59,2,2,0,2,NPC
cycloheximide_10uM_6h,cycloheximide,10 uM,6 h,5,54,59,2,118,63,55,NPC
JNJ-16259685_10uM_6h,JNJ-16259685,10 uM,6 h,5,54,59,2,0,0,0,NPC
vanoxerine_10uM_24h,vanoxerine,10 uM,24 h,5,50,55,2,22,16,6,NPC
clorgiline_10uM_24h,clorgiline,10 uM,24 h,5,66,71,2,18,10,8,NPC
MG-132_10uM_24h,MG-132,10 uM,24 h,5,50,55,3,622,224,398,NPC
RN-1_10uM_6h,RN-1,10 uM,6 h,5,54,59,2,1,1,0,NPC
CPCCOEt_10uM_6h,CPCCOEt,10 uM,6 h,5,54,59,2,0,0,0,NPC
RN-1_10uM_24h,RN-1,10 uM,24 h,5,66,71,2,0,0,0,NPC
NVP-BGJ398_0.04uM_24h,NVP-BGJ398,0.04 uM,24 h,5,109,114,3,22,10,12,NPC
TPCA-1_0.04uM_24h,TPCA-1,0.04 uM,24 h,5,109,114,2,41,18,23,NPC
MDL-29951_10uM_24h,MDL-29951,10 uM,24 h,4,37,41,1,3,0,3,NPC
SDZ-21009_10uM_24h,SDZ-21009,10 uM,24 h,4,39,43,1,2,0,2,NPC
ZM-306416_10uM_24h,ZM-306416,10 uM,24 h,4,40,44,1,1,1,0,NPC
BRL-50481_10uM_24h,BRL-50481,10 uM,24 h,4,40,44,1,0,0,0,NPC
WAY-170523_10uM_24h,WAY-170523,10 uM,24 h,4,37,41,1,1,1,0,NPC
SB-200646_10uM_24h,SB-200646,10 uM,24 h,4,40,44,1,0,0,0,NPC
SB-269970_10uM_24h,SB-269970,10 uM,24 h,4,39,43,1,0,0,0,NPC
SB-415286_10uM_24h,SB-415286,10 uM,24 h,4,37,41,1,0,0,0,NPC
L-152804_10uM_24h,L-152804,10 uM,24 h,4,39,43,1,28,6,22,NPC
cyclopiazonic-acid_10uM_24h,cyclopiazonic-acid,10 uM,24 h,4,40,44,1,7,5,2,NPC
aminomethyltransferase_10uM_24h,aminomethyltransferase,10 uM,24 h,4,39,43,1,44,7,37,NPC
BW-B70C_10uM_24h,BW-B70C,10 uM,24 h,4,39,43,1,3,2,1,NPC
SB-205384_10uM_24h,SB-205384,10 uM,24 h,4,39,43,1,5,0,5,NPC
BW-723C86_10uM_24h,BW-723C86,10 uM,24 h,4,40,44,1,0,0,0,NPC
nitrocaramiphen_10uM_24h,nitrocaramiphen,10 uM,24 h,4,40,44,1,0,0,0,NPC
EXO-1_10uM_24h,EXO-1,10 uM,24 h,4,40,44,1,1,0,1,NPC
T-0156_10uM_24h,T-0156,10 uM,24 h,4,40,44,1,0,0,0,NPC
PHTPP_10uM_24h,PHTPP,10 uM,24 h,4,39,43,1,0,0,0,NPC
RS-102221_10uM_24h,RS-102221,10 uM,24 h,4,40,44,1,0,0,0,NPC
naltrindole_10uM_24h,naltrindole,10 uM,24 h,4,40,44,1,0,0,0,NPC
U-18666A_10uM_24h,U-18666A,10 uM,24 h,4,40,44,1,6,5,1,NPC
trap-101_10uM_24h,trap-101,10 uM,24 h,4,40,44,1,15,8,7,NPC
NSC-95397_10uM_24h,NSC-95397,10 uM,24 h,4,37,41,1,11,5,6,NPC
SR-57227A_10uM_24h,SR-57227A,10 uM,24 h,4,40,44,1,22,14,8,NPC
PHA-767491_10uM_24h,PHA-767491,10 uM,24 h,4,87,91,2,739,288,451,NPC
phenolphthalein_10uM_24h,phenolphthalein,10 uM,24 h,4,37,41,1,0,0,0,NPC
bemesetron_10uM_24h,bemesetron,10 uM,24 h,4,40,44,1,105,50,55,NPC
ICI-89406_10uM_24h,ICI-89406,10 uM,24 h,4,39,43,1,2,0,2,NPC
levcromakalim_10uM_24h,levcromakalim,10 uM,24 h,4,39,43,1,4,1,3,NPC
PSB-11_10uM_24h,PSB-11,10 uM,24 h,4,39,43,1,1,1,0,NPC
DMP-543_10uM_24h,DMP-543,10 uM,24 h,4,40,44,1,3,2,1,NPC
ICI-63197_10uM_24h,ICI-63197,10 uM,24 h,4,37,41,1,0,0,0,NPC
GW-9508_10uM_24h,GW-9508,10 uM,24 h,4,39,43,1,3,1,2,NPC
L-745870_10uM_24h,L-745870,10 uM,24 h,4,40,44,1,1,1,0,NPC
pyrrolidine-dithiocarbamate_10uM_24h,pyrrolidine-dithiocarbamate,10 uM,24 h,4,40,44,1,10,9,1,NPC
OMDM-2_10uM_24h,OMDM-2,10 uM,24 h,4,39,43,1,16,3,13,NPC
ICI-162846_10uM_24h,ICI-162846,10 uM,24 h,4,39,43,1,1,1,0,NPC
pifithrin-alpha_10uM_24h,pifithrin-alpha,10 uM,24 h,4,37,41,1,0,0,0,NPC
RS-56812_10uM_24h,RS-56812,10 uM,24 h,4,40,44,1,69,43,26,NPC
dantron_10uM_24h,dantron,10 uM,24 h,4,37,41,1,0,0,0,NPC
XE-991_10uM_24h,XE-991,10 uM,24 h,4,37,41,1,8,5,3,NPC
KB-R7943_10uM_24h,KB-R7943,10 uM,24 h,4,39,43,1,4,0,4,NPC
embelin_10uM_24h,embelin,10 uM,24 h,4,40,44,1,0,0,0,NPC
homosalate_10uM_24h,homosalate,10 uM,24 h,4,37,41,1,1,1,0,NPC
YS-035_10uM_24h,YS-035,10 uM,24 h,4,39,43,1,7,3,4,NPC
apafant_10uM_24h,apafant,10 uM,24 h,4,40,44,1,2,1,1,NPC
NNC-63-0532_10uM_24h,NNC-63-0532,10 uM,24 h,4,40,44,1,0,0,0,NPC
pirenperone_10uM_24h,pirenperone,10 uM,24 h,4,37,41,1,0,0,0,NPC
PCO-400_10uM_24h,PCO-400,10 uM,24 h,4,39,43,1,5,1,4,NPC
GW-6471_10uM_24h,GW-6471,10 uM,24 h,4,37,41,1,6,3,3,NPC
NAS-181_10uM_24h,NAS-181,10 uM,24 h,4,37,41,1,0,0,0,NPC
ZK-93426_10uM_24h,ZK-93426,10 uM,24 h,4,39,43,1,11,5,6,NPC
PP-1_10uM_24h,PP-1,10 uM,24 h,4,40,44,1,106,43,63,NPC
AM-630_10uM_24h,AM-630,10 uM,24 h,4,40,44,1,0,0,0,NPC
monastrol_10uM_24h,monastrol,10 uM,24 h,4,40,44,1,3,1,2,NPC
alfadolone-acetate_10uM_24h,alfadolone-acetate,10 uM,24 h,4,39,43,1,0,0,0,NPC
BML-190_10uM_24h,BML-190,10 uM,24 h,4,40,44,1,0,0,0,NPC
ritanserin_10uM_24h,ritanserin,10 uM,24 h,4,37,41,1,0,0,0,NPC
PNU-282987_10uM_24h,PNU-282987,10 uM,24 h,4,37,41,1,0,0,0,NPC
alvocidib_10uM_24h,alvocidib,10 uM,24 h,4,38,42,2,0,0,0,NPC
oleoylethanolamide_10uM_6h,oleoylethanolamide,10 uM,6 h,4,36,40,2,13,3,10,NPC
RS-16566_10uM_24h,RS-16566,10 uM,24 h,4,40,44,1,0,0,0,NPC
loreclezole_10uM_24h,loreclezole,10 uM,24 h,4,40,44,1,0,0,0,NPC
strychnine_10uM_24h,strychnine,10 uM,24 h,4,37,41,1,0,0,0,NPC
limonin_10uM_24h,limonin,10 uM,24 h,4,39,43,1,0,0,0,NPC
Ro-04-5595_10uM_24h,Ro-04-5595,10 uM,24 h,4,40,44,1,1,1,0,NPC
nefazodone_10uM_24h,nefazodone,10 uM,24 h,4,40,44,1,0,0,0,NPC
necrostatin-1_10uM_24h,necrostatin-1,10 uM,24 h,4,37,41,1,0,0,0,NPC
PD-160170_10uM_24h,PD-160170,10 uM,24 h,4,40,44,1,5,2,3,NPC
CL-218872_10uM_24h,CL-218872,10 uM,24 h,4,40,44,1,2,1,1,NPC
zaprinast_10uM_24h,zaprinast,10 uM,24 h,4,39,43,1,8,3,5,NPC
SB-218795_10uM_24h,SB-218795,10 uM,24 h,4,39,43,1,0,0,0,NPC
remacemide_10uM_24h,remacemide,10 uM,24 h,4,37,41,1,33,24,9,NPC
WAY-100635_10uM_24h,WAY-100635,10 uM,24 h,4,58,62,2,1,1,0,NPC
dioxybenzone_10uM_24h,dioxybenzone,10 uM,24 h,4,39,43,1,0,0,0,NPC
SB-216641_10uM_24h,SB-216641,10 uM,24 h,4,40,44,1,0,0,0,NPC
ZD-7155_10uM_24h,ZD-7155,10 uM,24 h,4,39,43,1,6,1,5,NPC
SDZ-205-557_10uM_24h,SDZ-205-557,10 uM,24 h,4,40,44,1,0,0,0,NPC
NBQX_10uM_24h,NBQX,10 uM,24 h,4,37,41,1,15,9,6,NPC
gabazine_10uM_24h,gabazine,10 uM,24 h,4,40,44,1,5,4,1,NPC
MRS-1220_10uM_24h,MRS-1220,10 uM,24 h,4,40,44,1,7,5,2,NPC
BP-554_10uM_24h,BP-554,10 uM,24 h,4,40,44,1,1,1,0,NPC
MD-920_10uM_24h,MD-920,10 uM,24 h,4,39,43,1,0,0,0,NPC
roscovitine_10uM_24h,roscovitine,10 uM,24 h,4,39,43,1,19,5,14,NPC
phenformin_10uM_24h,phenformin,10 uM,24 h,4,40,44,1,0,0,0,NPC
SIB-1757_10uM_24h,SIB-1757,10 uM,24 h,4,40,44,1,7,4,3,NPC
NNC-711_10uM_24h,NNC-711,10 uM,24 h,4,40,44,1,0,0,0,NPC
JX-401_10uM_24h,JX-401,10 uM,24 h,4,39,43,1,4,2,2,NPC
MY-5445_10uM_24h,MY-5445,10 uM,24 h,4,39,43,1,29,5,24,NPC
Ro-15-4513_10uM_24h,Ro-15-4513,10 uM,24 h,4,40,44,1,1,0,1,NPC
MRS-1334_10uM_24h,MRS-1334,10 uM,24 h,4,39,43,1,1,1,0,NPC
piperine_10uM_24h,piperine,10 uM,24 h,4,40,44,1,0,0,0,NPC
CFM-1571_10uM_24h,CFM-1571,10 uM,24 h,4,39,43,1,3,1,2,NPC
Y-27152_10uM_24h,Y-27152,10 uM,24 h,4,37,41,1,1,1,0,NPC
SR-95639A_10uM_24h,SR-95639A,10 uM,24 h,4,40,44,1,191,78,113,NPC
isoflupredone-acetate_10uM_24h,isoflupredone-acetate,10 uM,24 h,4,39,43,1,1,0,1,NPC
FK-888_10uM_24h,FK-888,10 uM,24 h,4,40,44,1,2,2,0,NPC
telenzepine_10uM_24h,telenzepine,10 uM,24 h,4,40,44,1,0,0,0,NPC
diphenyleneiodonium_10uM_24h,diphenyleneiodonium,10 uM,24 h,4,39,43,1,419,159,260,NPC
MDL-72832_10uM_24h,MDL-72832,10 uM,24 h,4,39,43,1,70,13,57,NPC
H-89_10uM_24h,H-89,10 uM,24 h,4,39,43,1,3,0,3,NPC
GW-583340_10uM_24h,GW-583340,10 uM,24 h,4,39,43,1,14,7,7,NPC
relcovaptan_10uM_24h,relcovaptan,10 uM,24 h,4,40,44,1,0,0,0,NPC
EMD-386088_10uM_24h,EMD-386088,10 uM,24 h,4,37,41,1,1,1,0,NPC
SANT-1_10uM_24h,SANT-1,10 uM,24 h,4,40,44,1,1,1,0,NPC
PG-9_10uM_24h,PG-9,10 uM,24 h,4,40,44,1,0,0,0,NPC
BD-1063_10uM_24h,BD-1063,10 uM,24 h,4,39,43,1,1,0,1,NPC
FPL-55712_10uM_24h,FPL-55712,10 uM,24 h,4,40,44,1,15,9,6,NPC
EO-1428_10uM_24h,EO-1428,10 uM,24 h,4,39,43,1,17,10,7,NPC
L-755507_10uM_24h,L-755507,10 uM,24 h,4,37,41,1,0,0,0,NPC
FR-122047_10uM_24h,FR-122047,10 uM,24 h,4,40,44,1,0,0,0,NPC
SB-366791_10uM_24h,SB-366791,10 uM,24 h,4,40,44,1,6,4,2,NPC
siguazodan_10uM_24h,siguazodan,10 uM,24 h,4,39,43,1,0,0,0,NPC
icariin_10uM_24h,icariin,10 uM,24 h,4,39,43,1,0,0,0,NPC
CGP-12177_10uM_24h,CGP-12177,10 uM,24 h,4,39,43,1,18,6,12,NPC
DPPE_10uM_24h,DPPE,10 uM,24 h,4,40,44,1,1,0,1,NPC
rimcazole_10uM_24h,rimcazole,10 uM,24 h,4,40,44,1,3,1,2,NPC
RWJ-21757_10uM_24h,RWJ-21757,10 uM,24 h,4,37,41,1,0,0,0,NPC
xaliproden_10uM_24h,xaliproden,10 uM,24 h,4,40,44,1,0,0,0,NPC
SB-408124_10uM_24h,SB-408124,10 uM,24 h,4,40,44,1,1,1,0,NPC
GW-843682X_10uM_24h,GW-843682X,10 uM,24 h,4,40,44,1,53,21,32,NPC
PNU-120596_10uM_24h,PNU-120596,10 uM,24 h,4,39,43,1,6,2,4,NPC
SKF-86002_10uM_24h,SKF-86002,10 uM,24 h,4,40,44,1,0,0,0,NPC
puromycin_10uM_24h,puromycin,10 uM,24 h,4,40,44,1,0,0,0,NPC
ritodrine_10uM_24h,ritodrine,10 uM,24 h,4,37,41,1,2,1,1,NPC
GW-1929_10uM_24h,GW-1929,10 uM,24 h,4,37,41,1,26,14,12,NPC
desoxypeganine_10uM_24h,desoxypeganine,10 uM,24 h,4,37,41,1,0,0,0,NPC
BMY-14802_10uM_24h,BMY-14802,10 uM,24 h,4,39,43,1,24,10,14,NPC
CGP-37157_10uM_24h,CGP-37157,10 uM,24 h,4,40,44,1,5,3,2,NPC
nTZDpa_10uM_24h,nTZDpa,10 uM,24 h,4,39,43,1,0,0,0,NPC
osthol_10uM_24h,osthol,10 uM,24 h,4,40,44,1,0,0,0,NPC
phenacetin_10uM_24h,phenacetin,10 uM,24 h,4,37,41,1,0,0,0,NPC
AMG-9810_10uM_24h,AMG-9810,10 uM,24 h,4,37,41,1,4,3,1,NPC
calpeptin_10uM_24h,calpeptin,10 uM,24 h,4,39,43,1,115,47,68,NPC
securinine_10uM_24h,securinine,10 uM,24 h,4,37,41,1,3,2,1,NPC
rofecoxib_10uM_24h,rofecoxib,10 uM,24 h,4,37,41,1,1,1,0,NPC
BMS-191011_10uM_24h,BMS-191011,10 uM,24 h,4,40,44,1,0,0,0,NPC
NBI-27914_10uM_24h,NBI-27914,10 uM,24 h,4,40,44,1,25,17,8,NPC
SB-218078_10uM_24h,SB-218078,10 uM,24 h,4,40,44,1,75,26,49,NPC
cromakalim_10uM_24h,cromakalim,10 uM,24 h,4,40,44,1,0,0,0,NPC
ZM-323881_10uM_24h,ZM-323881,10 uM,24 h,4,40,44,1,20,12,8,NPC
CP-94253_10uM_24h,CP-94253,10 uM,24 h,4,40,44,1,0,0,0,NPC
asiatic-acid_10uM_24h,asiatic-acid,10 uM,24 h,4,39,43,1,1,0,1,NPC
vanoxerine_10uM_6h,vanoxerine,10 uM,6 h,4,44,48,2,43,15,28,NPC
BIBX-1382_10uM_24h,BIBX-1382,10 uM,24 h,4,37,41,1,2,2,0,NPC
L-701324_10uM_24h,L-701324,10 uM,24 h,4,39,43,1,0,0,0,NPC
CGS-20625_10uM_24h,CGS-20625,10 uM,24 h,4,40,44,1,0,0,0,NPC
DAU-5884_10uM_24h,DAU-5884,10 uM,24 h,4,40,44,1,5,5,0,NPC
purmorphamine_10uM_24h,purmorphamine,10 uM,24 h,4,39,43,1,29,11,18,NPC
olomoucine_10uM_24h,olomoucine,10 uM,24 h,4,40,44,1,49,28,21,NPC
Y-26763_10uM_24h,Y-26763,10 uM,24 h,4,37,41,1,2,2,0,NPC
IB-MECA_10uM_24h,IB-MECA,10 uM,24 h,4,39,43,1,7,3,4,NPC
UCL-2077_10uM_24h,UCL-2077,10 uM,24 h,4,39,43,1,4,4,0,NPC
fenretinide_10uM_6h,fenretinide,10 uM,6 h,4,36,40,2,25,11,14,NPC
norcyclobenzaprine_10uM_24h,norcyclobenzaprine,10 uM,24 h,4,40,44,1,0,0,0,NPC
GR-159897_10uM_24h,GR-159897,10 uM,24 h,4,39,43,1,0,0,0,NPC
SKF-77434_10uM_24h,SKF-77434,10 uM,24 h,4,40,44,1,52,23,29,NPC
desoxycortone_10uM_24h,desoxycortone,10 uM,24 h,4,40,44,1,1,1,0,NPC
BRL-54443_10uM_24h,BRL-54443,10 uM,24 h,4,40,44,1,3,2,1,NPC
CGP-55845_10uM_24h,CGP-55845,10 uM,24 h,4,40,44,1,0,0,0,NPC
AQ-RA741_10uM_24h,AQ-RA741,10 uM,24 h,4,40,44,1,0,0,0,NPC
PD-198306_10uM_24h,PD-198306,10 uM,24 h,4,40,44,1,257,101,156,NPC
PRE-084_10uM_24h,PRE-084,10 uM,24 h,4,37,41,1,1,0,1,NPC
BD-1008_10uM_24h,BD-1008,10 uM,24 h,4,39,43,1,1,1,0,NPC
bithionol_10uM_24h,bithionol,10 uM,24 h,4,37,41,1,172,62,110,NPC
WHI-P154_10uM_24h,WHI-P154,10 uM,24 h,4,39,43,1,57,34,23,NPC
equilin_10uM_24h,equilin,10 uM,24 h,4,40,44,2,0,0,0,NPC
KN-93_10uM_24h,KN-93,10 uM,24 h,4,40,44,1,304,125,179,NPC
SB-431542_10uM_24h,SB-431542,10 uM,24 h,4,39,43,1,249,98,151,NPC
Ro-60-0175_10uM_24h,Ro-60-0175,10 uM,24 h,4,40,44,1,0,0,0,NPC
T-0901317_10uM_24h,T-0901317,10 uM,24 h,4,39,43,1,27,8,19,NPC
prednisolone-hemisuccinate_10uM_24h,prednisolone-hemisuccinate,10 uM,24 h,4,37,41,1,1,1,0,NPC
remoxipride_10uM_24h,remoxipride,10 uM,24 h,4,40,44,1,5,4,1,NPC
PSB-06126_10uM_24h,PSB-06126,10 uM,24 h,4,37,41,1,1,1,0,NPC
C-1_10uM_24h,C-1,10 uM,24 h,4,40,44,1,0,0,0,NPC
SDZ-WAG-994_10uM_24h,SDZ-WAG-994,10 uM,24 h,4,37,41,1,0,0,0,NPC
quipazine_10uM_24h,quipazine,10 uM,24 h,4,37,41,1,0,0,0,NPC
cilostamide_10uM_24h,cilostamide,10 uM,24 h,4,40,44,1,51,17,34,NPC
CGP-13501_10uM_24h,CGP-13501,10 uM,24 h,4,40,44,1,0,0,0,NPC
wiskostatin_10uM_24h,wiskostatin,10 uM,24 h,4,40,44,1,48,17,31,NPC
arctigenin_10uM_24h,arctigenin,10 uM,24 h,4,40,44,1,8,4,4,NPC
NPC-15199_10uM_24h,NPC-15199,10 uM,24 h,4,39,43,1,6,1,5,NPC
JTE-907_10uM_24h,JTE-907,10 uM,24 h,4,39,43,1,4,2,2,NPC
L-368899_10uM_24h,L-368899,10 uM,24 h,4,39,43,1,0,0,0,NPC
isoxicam_10uM_24h,isoxicam,10 uM,24 h,4,37,41,1,2,1,1,NPC
oxyphenbutazone_10uM_24h,oxyphenbutazone,10 uM,24 h,4,50,54,2,139,59,80,NPC
methyllycaconitine_10uM_24h,methyllycaconitine,10 uM,24 h,4,39,43,1,3,1,2,NPC
Ro-10-5824_10uM_24h,Ro-10-5824,10 uM,24 h,4,40,44,1,0,0,0,NPC
Ro-19-4605_10uM_24h,Ro-19-4605,10 uM,24 h,4,40,44,1,0,0,0,NPC
azacyclonol_10uM_24h,azacyclonol,10 uM,24 h,4,40,44,1,0,0,0,NPC
colforsin_10uM_24h,colforsin,10 uM,24 h,4,37,41,1,5,3,2,NPC
NSC-3852_10uM_24h,NSC-3852,10 uM,24 h,4,41,45,2,581,236,345,NPC
naringenin_10uM_24h,naringenin,10 uM,24 h,4,40,44,1,0,0,0,NPC
sulmazole_10uM_24h,sulmazole,10 uM,24 h,4,37,41,1,0,0,0,NPC
MR-16728_10uM_24h,MR-16728,10 uM,24 h,4,37,41,1,3,2,1,NPC
PNU-22394_10uM_24h,PNU-22394,10 uM,24 h,4,40,44,1,0,0,0,NPC
cinchonine_10uM_24h,cinchonine,10 uM,24 h,4,40,44,1,0,0,0,NPC
SR-59230A_10uM_24h,SR-59230A,10 uM,24 h,4,40,44,1,0,0,0,NPC
EBPC_10uM_24h,EBPC,10 uM,24 h,4,39,43,1,0,0,0,NPC
AMN-082_10uM_24h,AMN-082,10 uM,24 h,4,40,44,1,1,0,1,NPC
FIT_10uM_24h,FIT,10 uM,24 h,4,39,43,1,1,0,1,NPC
naltriben_10uM_24h,naltriben,10 uM,24 h,4,39,43,1,13,3,10,NPC
vincamine_10uM_24h,vincamine,10 uM,24 h,4,37,41,1,2,2,0,NPC
MRS-1845_10uM_24h,MRS-1845,10 uM,24 h,4,39,43,1,1,0,1,NPC
NTNCB_10uM_24h,NTNCB,10 uM,24 h,4,40,44,1,21,10,11,NPC
SKF-89976A_10uM_24h,SKF-89976A,10 uM,24 h,4,40,44,1,2,2,0,NPC
ZD-2079_10uM_24h,ZD-2079,10 uM,24 h,4,39,43,1,0,0,0,NPC
NGB-2904_10uM_24h,NGB-2904,10 uM,24 h,4,39,43,1,0,0,0,NPC
meprylcaine_10uM_24h,meprylcaine,10 uM,24 h,4,40,44,1,0,0,0,NPC
gavestinel_10uM_24h,gavestinel,10 uM,24 h,4,39,43,1,8,2,6,NPC
zatebradine_10uM_24h,zatebradine,10 uM,24 h,4,40,44,1,0,0,0,NPC
RS-67506_10uM_24h,RS-67506,10 uM,24 h,4,39,43,1,1,0,1,NPC
NNC-05-2090_10uM_24h,NNC-05-2090,10 uM,24 h,4,40,44,1,72,31,41,NPC
BRL-37344_10uM_24h,BRL-37344,10 uM,24 h,4,37,41,1,2,1,1,NPC
AM-251_10uM_24h,AM-251,10 uM,24 h,4,40,44,1,0,0,0,NPC
butabindide_10uM_24h,butabindide,10 uM,24 h,4,40,44,1,9,5,4,NPC
lupanine_10uM_24h,lupanine,10 uM,24 h,4,37,41,1,0,0,0,NPC
MMPX_10uM_24h,MMPX,10 uM,24 h,4,39,43,1,1,0,1,NPC
arcyriaflavin-a_10uM_24h,arcyriaflavin-a,10 uM,24 h,4,37,41,1,7,5,2,NPC
m-3M3FBS_10uM_24h,m-3M3FBS,10 uM,24 h,4,39,43,1,13,2,11,NPC
betulinic-acid_10uM_24h,betulinic-acid,10 uM,24 h,4,40,44,1,0,0,0,NPC
brucine_10uM_24h,brucine,10 uM,24 h,4,40,44,1,1,1,0,NPC
clobenpropit_10uM_24h,clobenpropit,10 uM,24 h,4,39,43,1,95,21,74,NPC
DMAB-anabaseine_10uM_24h,DMAB-anabaseine,10 uM,24 h,4,39,43,1,55,21,34,NPC
BRL-15572_10uM_24h,BRL-15572,10 uM,24 h,4,39,43,1,0,0,0,NPC
desmethylclozapine_10uM_24h,desmethylclozapine,10 uM,24 h,4,40,44,1,53,31,22,NPC
esculin_10uM_24h,esculin,10 uM,24 h,4,39,43,1,9,1,8,NPC
AM-404_10uM_24h,AM-404,10 uM,24 h,4,39,43,1,270,118,152,NPC
SCH-58261_10uM_24h,SCH-58261,10 uM,24 h,4,39,43,1,4,2,2,NPC
BMY-7378_10uM_24h,BMY-7378,10 uM,24 h,4,40,44,1,48,25,23,NPC
emetine_10uM_24h,emetine,10 uM,24 h,4,39,43,1,434,174,260,NPC
erythrosine_10uM_24h,erythrosine,10 uM,24 h,4,37,41,1,35,11,24,NPC
YC-1_10uM_24h,YC-1,10 uM,24 h,4,39,43,1,24,5,19,NPC
nafadotride_10uM_24h,nafadotride,10 uM,24 h,4,39,43,1,0,0,0,NPC
L-655240_10uM_24h,L-655240,10 uM,24 h,4,40,44,1,0,0,0,NPC
RS-67333_10uM_24h,RS-67333,10 uM,24 h,4,39,43,1,1,0,1,NPC
proadifen_10uM_24h,proadifen,10 uM,24 h,4,40,44,1,1,1,0,NPC
GR-113808_10uM_24h,GR-113808,10 uM,24 h,4,37,41,1,1,1,0,NPC
devazepide_10uM_24h,devazepide,10 uM,24 h,4,40,44,1,0,0,0,NPC
fenoterol_10uM_24h,fenoterol,10 uM,24 h,4,40,44,1,0,0,0,NPC
FR-139317_10uM_24h,FR-139317,10 uM,24 h,4,40,44,1,2,1,1,NPC
BE-2254_10uM_24h,BE-2254,10 uM,24 h,4,39,43,1,18,4,14,NPC
KN-62_10uM_24h,KN-62,10 uM,24 h,4,39,43,1,0,0,0,NPC
iodophenpropit_10uM_24h,iodophenpropit,10 uM,24 h,4,39,43,1,5,1,4,NPC
ZK-164015_10uM_24h,ZK-164015,10 uM,24 h,4,39,43,1,33,11,22,NPC
KF-38789_10uM_24h,KF-38789,10 uM,24 h,4,39,43,1,348,151,197,NPC
E-4031_10uM_24h,E-4031,10 uM,24 h,4,39,43,1,5,2,3,NPC
SB-225002_10uM_24h,SB-225002,10 uM,24 h,4,39,43,1,156,70,86,NPC
SR-27897_10uM_24h,SR-27897,10 uM,24 h,4,40,44,1,4,4,0,NPC
JTE-013_10uM_24h,JTE-013,10 uM,24 h,4,39,43,1,22,11,11,NPC
pentylenetetrazol_10uM_24h,pentylenetetrazol,10 uM,24 h,4,37,41,1,0,0,0,NPC
alrestatin_10uM_24h,alrestatin,10 uM,24 h,4,40,44,1,2,1,1,NPC
CI-966_10uM_24h,CI-966,10 uM,24 h,4,40,44,1,0,0,0,NPC
L-733060_10uM_24h,L-733060,10 uM,24 h,4,39,43,1,212,72,140,NPC
zoxazolamine_10uM_24h,zoxazolamine,10 uM,24 h,4,37,41,1,0,0,0,NPC
GR-144053_10uM_24h,GR-144053,10 uM,24 h,4,39,43,1,151,33,118,NPC
deoxycorticosterone-acetate_10uM_24h,deoxycorticosterone-acetate,10 uM,24 h,4,37,41,1,5,3,2,NPC
SC-9_10uM_24h,SC-9,10 uM,24 h,4,40,44,1,0,0,0,NPC
flurofamide_10uM_24h,flurofamide,10 uM,24 h,4,40,44,1,0,0,0,NPC
practolol_10uM_24h,practolol,10 uM,24 h,4,37,41,1,0,0,0,NPC
CP-93129_10uM_24h,CP-93129,10 uM,24 h,4,40,44,1,0,0,0,NPC
Y-134_10uM_24h,Y-134,10 uM,24 h,4,40,44,1,15,9,6,NPC
GR-127935_10uM_24h,GR-127935,10 uM,24 h,4,39,43,1,199,74,125,NPC
pergolide_10uM_24h,pergolide,10 uM,24 h,4,37,41,1,1,1,0,NPC
ITE_10uM_24h,ITE,10 uM,24 h,4,39,43,1,0,0,0,NPC
U-99194_10uM_24h,U-99194,10 uM,24 h,4,40,44,1,0,0,0,NPC
GBR-13069_10uM_24h,GBR-13069,10 uM,24 h,4,39,43,1,6,3,3,NPC
terfenadine_10uM_24h,terfenadine,10 uM,24 h,4,37,41,1,0,0,0,NPC
zardaverine_10uM_24h,zardaverine,10 uM,24 h,4,40,44,1,265,113,152,NPC
GW-311616_10uM_24h,GW-311616,10 uM,24 h,4,39,43,1,13,1,12,NPC
JLK-6_10uM_24h,JLK-6,10 uM,24 h,4,40,44,1,0,0,0,NPC
PQ-401_10uM_24h,PQ-401,10 uM,24 h,4,40,44,1,0,0,0,NPC
GTP-14564_10uM_24h,GTP-14564,10 uM,24 h,4,40,44,1,31,16,15,NPC
etifenin_10uM_24h,etifenin,10 uM,24 h,4,39,43,1,3,0,3,NPC
ODQ_10uM_24h,ODQ,10 uM,24 h,4,39,43,1,4,1,3,NPC
DNQX_10uM_24h,DNQX,10 uM,24 h,4,40,44,1,0,0,0,NPC
LE-135_10uM_24h,LE-135,10 uM,24 h,4,37,41,1,0,0,0,NPC
ZD-7114_10uM_24h,ZD-7114,10 uM,24 h,4,37,41,1,0,0,0,NPC
pinocembrin_10uM_24h,pinocembrin,10 uM,24 h,4,40,44,1,2,1,1,NPC
hydrastinine_10uM_24h,hydrastinine,10 uM,24 h,4,40,44,1,2,0,2,NPC
JNJ-10191584_10uM_24h,JNJ-10191584,10 uM,24 h,4,39,43,1,7,2,5,NPC
SCH-23390_10uM_24h,SCH-23390,10 uM,24 h,4,40,44,1,1,1,0,NPC
DR-2313_10uM_24h,DR-2313,10 uM,24 h,4,40,44,1,0,0,0,NPC
IRL-2500_10uM_24h,IRL-2500,10 uM,24 h,4,39,43,1,0,0,0,NPC
PD-123319_10uM_24h,PD-123319,10 uM,24 h,4,40,44,1,12,5,7,NPC
RHC-80267_10uM_24h,RHC-80267,10 uM,24 h,4,40,44,1,9,5,4,NPC
alaproclate_10uM_24h,alaproclate,10 uM,24 h,4,37,41,1,1,1,0,NPC
REV-5901_10uM_24h,REV-5901,10 uM,24 h,4,39,43,1,136,45,91,NPC
isamoltane_10uM_24h,isamoltane,10 uM,24 h,4,39,43,1,6,2,4,NPC
CGP-60474_0.04uM_24h,CGP-60474,0.04 uM,24 h,4,99,103,2,630,238,392,NPC
tangeritin_10uM_24h,tangeritin,10 uM,24 h,3,32,35,1,3,3,0,NPC
anabasine_10uM_24h,anabasine,10 uM,24 h,3,32,35,1,1,1,0,NPC
capsazepine_10uM_24h,capsazepine,10 uM,24 h,3,32,35,1,10,4,6,NPC
BAY-11-7082_10uM_24h,BAY-11-7082,10 uM,24 h,3,32,35,1,38,12,26,NPC
tandutinib_10uM_24h,tandutinib,10 uM,24 h,3,27,30,1,1,0,1,NPC
ZM-241385_10uM_24h,ZM-241385,10 uM,24 h,3,32,35,1,1,1,0,NPC
altanserin_10uM_24h,altanserin,10 uM,24 h,3,32,35,1,2,2,0,NPC
UBP-302_10uM_24h,UBP-302,10 uM,24 h,3,32,35,1,0,0,0,NPC
GW-0742_10uM_24h,GW-0742,10 uM,24 h,3,32,35,1,3,3,0,NPC
GW-405833_10uM_24h,GW-405833,10 uM,24 h,3,32,35,1,0,0,0,NPC
danusertib_10uM_24h,danusertib,10 uM,24 h,3,27,30,1,1,0,1,NPC
10-DEBC_10uM_24h,10-DEBC,10 uM,24 h,3,31,34,1,207,73,134,NPC
SDZ-NKT-343_10uM_24h,SDZ-NKT-343,10 uM,24 h,3,27,30,1,1,1,0,NPC
BX-912_10uM_24h,BX-912,10 uM,24 h,3,29,32,1,234,87,147,NPC
tracazolate_10uM_24h,tracazolate,10 uM,24 h,3,32,35,1,0,0,0,NPC
SC-560_10uM_24h,SC-560,10 uM,24 h,3,32,35,1,2,1,1,NPC
GANT-61_10uM_24h,GANT-61,10 uM,24 h,3,27,30,1,1,0,1,NPC
YM-90709_10uM_24h,YM-90709,10 uM,24 h,3,32,35,1,43,19,24,NPC
ilomastat_10uM_24h,ilomastat,10 uM,24 h,3,32,35,1,0,0,0,NPC
etomoxir_10uM_24h,etomoxir,10 uM,24 h,3,29,32,1,0,0,0,NPC
L-161982_10uM_24h,L-161982,10 uM,24 h,3,25,28,1,227,82,145,NPC
CGP-52411_10uM_24h,CGP-52411,10 uM,24 h,3,29,32,1,48,20,28,NPC
L-693403_10uM_24h,L-693403,10 uM,24 h,3,27,30,1,0,0,0,NPC
ST-91_10uM_24h,ST-91,10 uM,24 h,3,32,35,1,0,0,0,NPC
zolantidine_10uM_24h,zolantidine,10 uM,24 h,3,32,35,1,4,3,1,NPC
tenidap_10uM_24h,tenidap,10 uM,24 h,3,30,33,1,1,1,0,NPC
orantinib_10uM_24h,orantinib,10 uM,24 h,3,29,32,1,0,0,0,NPC
AT-7519_10uM_24h,AT-7519,10 uM,24 h,3,27,30,1,4,1,3,NPC
3-methyl-GABA_10uM_24h,3-methyl-GABA,10 uM,24 h,3,32,35,1,2,1,1,NPC
brivanib_10uM_24h,brivanib,10 uM,24 h,3,29,32,1,11,7,4,NPC
ZD-7288_10uM_24h,ZD-7288,10 uM,24 h,3,32,35,1,0,0,0,NPC
dorsomorphin_10uM_24h,dorsomorphin,10 uM,24 h,3,32,35,1,14,8,6,NPC
benzamil_10uM_24h,benzamil,10 uM,24 h,3,32,35,1,2,1,1,NPC
fexaramine_10uM_24h,fexaramine,10 uM,24 h,3,32,35,1,1,0,1,NPC
GBR-12935_10uM_24h,GBR-12935,10 uM,24 h,3,32,35,1,1,0,1,NPC
PK-11195_10uM_24h,PK-11195,10 uM,24 h,3,32,35,1,0,0,0,NPC
DUP-697_10uM_24h,DUP-697,10 uM,24 h,3,32,35,1,0,0,0,NPC
PCI-24781_10uM_24h,PCI-24781,10 uM,24 h,3,31,34,1,388,185,203,NPC
WAY-213613_10uM_24h,WAY-213613,10 uM,24 h,3,31,34,1,21,6,15,NPC
SIB-1893_10uM_24h,SIB-1893,10 uM,24 h,3,32,35,1,67,29,38,NPC
danoprevir_10uM_24h,danoprevir,10 uM,24 h,3,29,32,1,1,1,0,NPC
AS-604850_10uM_24h,AS-604850,10 uM,24 h,3,29,32,1,0,0,0,NPC
DMeOB_10uM_24h,DMeOB,10 uM,24 h,3,32,35,1,5,4,1,NPC
PU-H71_10uM_24h,PU-H71,10 uM,24 h,3,29,32,1,506,204,302,NPC
PD-407824_10uM_24h,PD-407824,10 uM,24 h,3,31,34,1,456,186,270,NPC
PIK-75_10uM_24h,PIK-75,10 uM,24 h,3,29,32,1,2,1,1,NPC
m-chlorophenylbiguanide_10uM_24h,m-chlorophenylbiguanide,10 uM,24 h,3,32,35,1,0,0,0,NPC
LFM-A13_10uM_24h,LFM-A13,10 uM,24 h,3,32,35,1,24,21,3,NPC
semaxanib_10uM_24h,semaxanib,10 uM,24 h,3,31,34,1,13,5,8,NPC
zaldaride_10uM_24h,zaldaride,10 uM,24 h,3,29,32,1,0,0,0,NPC
DCPIB_10uM_24h,DCPIB,10 uM,24 h,3,32,35,1,0,0,0,NPC
nobiletin_10uM_24h,nobiletin,10 uM,24 h,3,32,35,1,0,0,0,NPC
BD-1047_10uM_24h,BD-1047,10 uM,24 h,3,32,35,1,70,27,43,NPC
SB-221284_10uM_24h,SB-221284,10 uM,24 h,3,32,35,1,0,0,0,NPC
GW-3965_10uM_24h,GW-3965,10 uM,24 h,3,29,32,1,32,8,24,NPC
givinostat_10uM_24h,givinostat,10 uM,24 h,3,29,32,1,0,0,0,NPC
obatoclax_10uM_24h,obatoclax,10 uM,24 h,3,27,30,1,0,0,0,NPC
SNS-314_10uM_24h,SNS-314,10 uM,24 h,3,27,30,1,69,38,31,NPC
GR-79236_10uM_24h,GR-79236,10 uM,24 h,3,32,35,1,2,2,0,NPC
phenylbutazone_10uM_24h,phenylbutazone,10 uM,24 h,3,32,35,1,0,0,0,NPC
SB-334867_10uM_24h,SB-334867,10 uM,24 h,3,32,35,1,0,0,0,NPC
PD-168077_10uM_24h,PD-168077,10 uM,24 h,3,29,32,1,0,0,0,NPC
IBC-293_10uM_24h,IBC-293,10 uM,24 h,3,32,35,1,0,0,0,NPC
reversine_10uM_24h,reversine,10 uM,24 h,3,29,32,1,6,1,5,NPC
ditolylguanidine_10uM_24h,ditolylguanidine,10 uM,24 h,3,32,35,1,0,0,0,NPC
GW-501516_10uM_24h,GW-501516,10 uM,24 h,3,29,32,1,9,5,4,NPC
UB-165_10uM_24h,UB-165,10 uM,24 h,3,26,29,1,142,52,90,NPC
canertinib_10uM_24h,canertinib,10 uM,24 h,3,29,32,1,3,2,1,NPC
BI-78D3_10uM_24h,BI-78D3,10 uM,24 h,3,29,32,1,6,3,3,NPC
digoxigenin_10uM_24h,digoxigenin,10 uM,24 h,3,32,35,1,0,0,0,NPC
KI-16425_10uM_24h,KI-16425,10 uM,24 h,3,27,30,1,37,17,20,NPC
TGX-221_10uM_24h,TGX-221,10 uM,24 h,3,29,32,1,1,0,1,NPC
INCA-6_10uM_24h,INCA-6,10 uM,24 h,3,32,35,1,1,1,0,NPC
T-0070907_10uM_24h,T-0070907,10 uM,24 h,3,32,35,1,0,0,0,NPC
salicin_10uM_24h,salicin,10 uM,24 h,3,27,30,1,0,0,0,NPC
plumbagin_10uM_24h,plumbagin,10 uM,24 h,3,34,37,2,684,243,441,NPC
DH-97_10uM_24h,DH-97,10 uM,24 h,3,32,35,1,0,0,0,NPC
saclofen_10uM_24h,saclofen,10 uM,24 h,3,32,35,1,0,0,0,NPC
SEW-2871_10uM_24h,SEW-2871,10 uM,24 h,3,32,35,1,0,0,0,NPC
PHA-793887_10uM_24h,PHA-793887,10 uM,24 h,3,29,32,1,4,2,2,NPC
cisapride_10uM_24h,cisapride,10 uM,24 h,3,32,35,1,0,0,0,NPC
PPT_10uM_24h,PPT,10 uM,24 h,3,32,35,1,5,2,3,NPC
tiotidine_10uM_24h,tiotidine,10 uM,24 h,3,32,35,1,0,0,0,NPC
NAN-190_10uM_24h,NAN-190,10 uM,24 h,3,32,35,1,347,142,205,NPC
cinanserin_10uM_24h,cinanserin,10 uM,24 h,3,32,35,1,0,0,0,NPC
WYE-125132_10uM_24h,WYE-125132,10 uM,24 h,3,29,32,1,107,32,75,NPC
L-694247_10uM_24h,L-694247,10 uM,24 h,3,32,35,1,0,0,0,NPC
NU-1025_10uM_24h,NU-1025,10 uM,24 h,3,32,35,1,0,0,0,NPC
butein_10uM_24h,butein,10 uM,24 h,3,32,35,1,147,55,92,NPC
PD-166793_10uM_24h,PD-166793,10 uM,24 h,3,27,30,1,0,0,0,NPC
zibotentan_10uM_24h,zibotentan,10 uM,24 h,3,27,30,1,0,0,0,NPC
JNJ-7706621_10uM_24h,JNJ-7706621,10 uM,24 h,3,27,30,1,0,0,0,NPC
SC-10_10uM_24h,SC-10,10 uM,24 h,3,32,35,1,0,0,0,NPC
FPL-64176_10uM_24h,FPL-64176,10 uM,24 h,3,32,35,1,0,0,0,NPC
L-165041_10uM_24h,L-165041,10 uM,24 h,3,32,35,1,1,1,0,NPC
YM-976_10uM_24h,YM-976,10 uM,24 h,3,32,35,1,1,1,0,NPC
CCMQ_10uM_24h,CCMQ,10 uM,24 h,3,32,35,1,2,1,1,NPC
BU-239_10uM_24h,BU-239,10 uM,24 h,3,30,33,1,118,40,78,NPC
cilomilast_10uM_24h,cilomilast,10 uM,24 h,3,27,30,1,1,1,0,NPC
RS-45041-190_10uM_24h,RS-45041-190,10 uM,24 h,3,27,30,1,0,0,0,NPC
WZ-3146_10uM_24h,WZ-3146,10 uM,24 h,3,29,32,1,3,2,1,NPC
TC-H-106_10uM_24h,TC-H-106,10 uM,24 h,3,27,30,1,0,0,0,NPC
immethridine_10uM_24h,immethridine,10 uM,24 h,3,28,31,1,0,0,0,NPC
AZ-10417808_10uM_24h,AZ-10417808,10 uM,24 h,3,32,35,1,3,2,1,NPC
6-aminochrysene_10uM_24h,6-aminochrysene,10 uM,24 h,3,29,32,1,0,0,0,NPC
PIT_10uM_24h,PIT,10 uM,24 h,3,32,35,1,0,0,0,NPC
AY-9944_10uM_24h,AY-9944,10 uM,24 h,3,32,35,1,0,0,0,NPC
AS-703026_10uM_24h,AS-703026,10 uM,24 h,3,29,32,1,30,17,13,NPC
cinalukast_10uM_24h,cinalukast,10 uM,24 h,3,32,35,1,0,0,0,NPC
mirin_10uM_24h,mirin,10 uM,24 h,3,29,32,1,2,1,1,NPC
cirazoline_10uM_24h,cirazoline,10 uM,24 h,3,32,35,1,0,0,0,NPC
HA-1004_10uM_24h,HA-1004,10 uM,24 h,3,32,35,1,10,4,6,NPC
L-701252_10uM_24h,L-701252,10 uM,24 h,3,31,34,1,434,174,260,NPC
neurodazine_10uM_24h,neurodazine,10 uM,24 h,3,29,32,1,7,5,2,NPC
CGP-71683_10uM_24h,CGP-71683,10 uM,24 h,3,28,31,1,488,222,266,NPC
alvespimycin_10uM_24h,alvespimycin,10 uM,24 h,3,29,32,1,43,10,33,NPC
andarine_10uM_24h,andarine,10 uM,24 h,3,27,30,1,0,0,0,NPC
caffeic-acid_10uM_24h,caffeic-acid,10 uM,24 h,3,30,33,1,54,38,16,NPC
cediranib_10uM_24h,cediranib,10 uM,24 h,3,29,32,1,339,139,200,NPC
roquinimex_10uM_24h,roquinimex,10 uM,24 h,3,32,35,1,0,0,0,NPC
BP-897_10uM_24h,BP-897,10 uM,24 h,3,32,35,1,0,0,0,NPC
PCA-4248_10uM_24h,PCA-4248,10 uM,24 h,3,32,35,1,3,2,1,NPC
SB-222200_10uM_24h,SB-222200,10 uM,24 h,3,31,34,1,3,3,0,NPC
ICI-199441_10uM_24h,ICI-199441,10 uM,24 h,3,32,35,1,0,0,0,NPC
CO-102862_10uM_24h,CO-102862,10 uM,24 h,3,32,35,1,0,0,0,NPC
immepip_10uM_24h,immepip,10 uM,24 h,3,32,35,1,22,15,7,NPC
anisomycin_10uM_24h,anisomycin,10 uM,24 h,3,31,34,1,530,198,332,NPC
VX-222_10uM_24h,VX-222,10 uM,24 h,3,29,32,1,7,5,2,NPC
tyrphostin-A9_10uM_24h,tyrphostin-A9,10 uM,24 h,3,29,32,1,0,0,0,NPC
ZK-93423_10uM_24h,ZK-93423,10 uM,24 h,3,32,35,1,13,11,2,NPC
vesamicol_10uM_24h,vesamicol,10 uM,24 h,3,32,35,1,0,0,0,NPC
WYE-354_10uM_24h,WYE-354,10 uM,24 h,3,29,32,1,107,39,68,NPC
RS-100329_10uM_24h,RS-100329,10 uM,24 h,3,32,35,1,0,0,0,NPC
thiorphan_10uM_24h,thiorphan,10 uM,24 h,3,32,35,1,0,0,0,NPC
PD-102807_10uM_24h,PD-102807,10 uM,24 h,3,32,35,1,1,1,0,NPC
amthamine_10uM_24h,amthamine,10 uM,24 h,3,32,35,1,0,0,0,NPC
CGP-53353_10uM_24h,CGP-53353,10 uM,24 h,3,32,35,1,0,0,0,NPC
tremorine_10uM_24h,tremorine,10 uM,24 h,3,32,35,1,1,1,0,NPC
pyroxamide_10uM_24h,pyroxamide,10 uM,24 h,3,27,30,1,109,42,67,NPC
NU-7441_10uM_24h,NU-7441,10 uM,24 h,3,29,32,1,8,4,4,NPC
fananserin_10uM_24h,fananserin,10 uM,24 h,3,32,35,1,3,2,1,NPC
RS-504393_10uM_24h,RS-504393,10 uM,24 h,3,30,33,1,0,0,0,NPC
OSI-027_10uM_24h,OSI-027,10 uM,24 h,3,29,32,1,155,51,104,NPC
SKF-96365_10uM_24h,SKF-96365,10 uM,24 h,3,32,35,1,5,2,3,NPC
vicriviroc_10uM_24h,vicriviroc,10 uM,24 h,3,29,32,1,0,0,0,NPC
JNJ-26481585_10uM_24h,JNJ-26481585,10 uM,24 h,3,29,32,1,32,21,11,NPC
dehydrocholate_10uM_24h,dehydrocholate,10 uM,24 h,3,31,34,1,204,61,143,NPC
proxyfan_10uM_24h,proxyfan,10 uM,24 h,3,32,35,1,0,0,0,NPC
carmoxirole_10uM_24h,carmoxirole,10 uM,24 h,3,27,30,1,1,0,1,NPC
MNITMT_10uM_24h,MNITMT,10 uM,24 h,3,32,35,1,0,0,0,NPC
zosuquidar_10uM_24h,zosuquidar,10 uM,24 h,3,29,32,1,14,7,7,NPC
D-64131_10uM_24h,D-64131,10 uM,24 h,3,32,35,1,96,34,62,NPC
hypericin_10uM_24h,hypericin,10 uM,24 h,3,28,31,1,5,3,2,NPC
O-1918_10uM_24h,O-1918,10 uM,24 h,3,32,35,1,0,0,0,NPC
10-DEBC_10uM_6h,10-DEBC,10 uM,6 h,3,28,31,1,0,0,0,NPC
CGP-7930_10uM_24h,CGP-7930,10 uM,24 h,3,32,35,1,0,0,0,NPC
GYKI-52466_10uM_24h,GYKI-52466,10 uM,24 h,3,32,35,1,0,0,0,NPC
GS-39783_10uM_24h,GS-39783,10 uM,24 h,3,32,35,1,0,0,0,NPC
PI-828_10uM_24h,PI-828,10 uM,24 h,3,32,35,1,300,115,185,NPC
R-96544_10uM_24h,R-96544,10 uM,24 h,3,32,35,1,0,0,0,NPC
linifanib_10uM_24h,linifanib,10 uM,24 h,3,29,32,1,1,1,0,NPC
CGP-57380_10uM_24h,CGP-57380,10 uM,24 h,3,28,31,1,28,22,6,NPC
torin-1_10uM_24h,torin-1,10 uM,24 h,3,29,32,1,193,76,117,NPC
1-phenylbiguanide_10uM_24h,1-phenylbiguanide,10 uM,24 h,3,32,35,1,359,151,208,NPC
VX-702_10uM_24h,VX-702,10 uM,24 h,3,29,32,1,2,1,1,NPC
mefexamide_10uM_24h,mefexamide,10 uM,24 h,3,32,35,1,0,0,0,NPC
CGP-60474_1.11uM_24h,CGP-60474,1.11 uM,24 h,3,77,80,3,723,293,430,NPC
nacl_0.12uM_6h,nacl,0.12 uM,6 h,131,109,240,4,198,74,124,NPC
nacl_0.12uM_24h,nacl,0.12 uM,24 h,130,124,254,4,219,100,119,NPC
kcl_0.12uM_24h,kcl,0.12 uM,24 h,129,124,253,4,390,141,249,NPC
kcl_0.12uM_6h,kcl,0.12 uM,6 h,129,109,238,4,272,104,168,NPC
BRD-A19037878_10uM_24h,BRD-A19037878,10 uM,24 h,39,439,478,13,746,383,363,NPC
GSK-1059615_0.04uM_24h,GSK-1059615,0.04 uM,24 h,34,598,632,9,115,51,64,NPC
GSK-1059615_0.12uM_24h,GSK-1059615,0.12 uM,24 h,34,598,632,9,165,76,89,NPC
GSK-1059615_1.11uM_24h,GSK-1059615,1.11 uM,24 h,34,598,632,9,447,181,266,NPC
GSK-1059615_0.37uM_24h,GSK-1059615,0.37 uM,24 h,33,598,631,9,167,90,77,NPC
GSK-1059615_3.33uM_24h,GSK-1059615,3.33 uM,24 h,33,576,609,9,631,223,408,NPC
GSK-1059615_10uM_24h,GSK-1059615,10 uM,24 h,25,448,473,7,675,240,435,NPC
I-BET-151_10uM_24h,I-BET-151,10 uM,24 h,24,634,658,8,655,336,319,NPC
AGK-2_10uM_24h,AGK-2,10 uM,24 h,20,375,395,7,341,123,218,NPC
BG-1005_10uM_24h,BG-1005,10 uM,24 h,19,424,443,7,847,389,458,NPC
BRD-K55591206_10uM_24h,BRD-K55591206,10 uM,24 h,18,338,356,6,2,1,1,NPC
BRD-K68202742_10uM_24h,BRD-K68202742,10 uM,24 h,18,114,132,4,653,315,338,NPC
BRD-A26030894_125uM_24h,BRD-A26030894,125 uM,24 h,15,383,398,5,100,49,51,NPC
BRD-A26030894_60uM_24h,BRD-A26030894,60 uM,24 h,15,383,398,5,67,37,30,NPC
BRD-A26030894_30uM_24h,BRD-A26030894,30 uM,24 h,15,383,398,5,41,28,13,NPC
LY-456236_10uM_24h,LY-456236,10 uM,24 h,15,164,179,5,236,114,122,NPC
cyclosporin-a_10uM_24h,cyclosporin-a,10 uM,24 h,15,111,126,3,119,49,70,NPC
BRD-K41170226_10uM_24h,BRD-K41170226,10 uM,24 h,15,87,102,3,5,2,3,NPC
garcinol_10uM_24h,garcinol,10 uM,24 h,15,309,324,5,56,28,28,NPC
GSK-429286A_10uM_24h,GSK-429286A,10 uM,24 h,15,221,236,4,209,95,114,NPC
anacardic-acid_10uM_24h,anacardic-acid,10 uM,24 h,15,309,324,5,2,1,1,NPC
AZD-8055_10uM_24h,AZD-8055,10 uM,24 h,15,383,398,5,580,236,344,NPC
apicidin_10uM_24h,apicidin,10 uM,24 h,15,85,100,3,583,268,315,NPC
17-AAG_10uM_24h,17-AAG,10 uM,24 h,15,383,398,5,666,281,385,NPC
lorazepam_3.33uM_24h,lorazepam,3.33 uM,24 h,15,383,398,5,1,1,0,NPC
ketamine_3.33uM_24h,ketamine,3.33 uM,24 h,15,383,398,5,5,5,0,NPC
zopiclone_3.33uM_24h,zopiclone,3.33 uM,24 h,15,383,398,5,0,0,0,NPC
modafinil_3.33uM_24h,modafinil,3.33 uM,24 h,15,383,398,5,28,15,13,NPC
BRD-K01543453_3.33uM_24h,BRD-K01543453,3.33 uM,24 h,15,383,398,5,106,72,34,NPC
BRD-K89997465_3.33uM_24h,BRD-K89997465,3.33 uM,24 h,15,383,398,5,20,12,8,NPC
PF-06260933_3.33uM_24h,PF-06260933,3.33 uM,24 h,15,383,398,5,17,17,0,NPC
bizine_3.33uM_24h,bizine,3.33 uM,24 h,15,383,398,5,3,3,0,NPC
clonazepam_3.33uM_24h,clonazepam,3.33 uM,24 h,15,383,398,5,12,3,9,NPC
methylphenidate_3.33uM_24h,methylphenidate,3.33 uM,24 h,15,383,398,5,42,30,12,NPC
BRD-A90543464_10uM_24h,BRD-A90543464,10 uM,24 h,14,359,373,5,73,50,23,NPC
LY-2365109_3.33uM_24h,LY-2365109,3.33 uM,24 h,14,358,372,5,23,8,15,NPC
NPK76-II-72-1_10uM_24h,NPK76-II-72-1,10 uM,24 h,12,280,292,4,424,172,252,NPC
BRD-K05396879_10uM_24h,BRD-K05396879,10 uM,24 h,12,116,128,4,1,1,0,NPC
KIN001-127_10uM_24h,KIN001-127,10 uM,24 h,12,223,235,4,426,171,255,NPC
KIN001-242_10uM_24h,KIN001-242,10 uM,24 h,12,223,235,4,2,2,0,NPC
XMD-892_10uM_24h,XMD-892,10 uM,24 h,12,223,235,4,272,123,149,NPC
apicidin_10uM_6h,apicidin,10 uM,6 h,12,55,67,2,268,116,152,NPC
MLN-8054_10uM_24h,MLN-8054,10 uM,24 h,12,223,235,4,69,41,28,NPC
CG-930_10uM_24h,CG-930,10 uM,24 h,12,223,235,4,50,23,27,NPC
AZD-7762_10uM_24h,AZD-7762,10 uM,24 h,12,221,233,4,196,92,104,NPC
LY-294002_10uM_24h,LY-294002,10 uM,24 h,12,157,169,4,128,33,95,NPC
alitretinoin_10uM_24h,alitretinoin,10 uM,24 h,12,116,128,4,21,17,4,NPC
QL-XI-92_10uM_24h,QL-XI-92,10 uM,24 h,12,223,235,4,235,89,146,NPC
BRD-K41170226_10uM_6h,BRD-K41170226,10 uM,6 h,12,55,67,2,57,18,39,NPC
GSK-461364_10uM_24h,GSK-461364,10 uM,24 h,12,278,290,4,669,269,400,NPC
BRD-K37846922_10uM_24h,BRD-K37846922,10 uM,24 h,12,119,131,4,0,0,0,NPC
ALW-II-38-3_10uM_24h,ALW-II-38-3,10 uM,24 h,12,221,233,4,79,38,41,NPC
BRD-K68202742_10uM_6h,BRD-K68202742,10 uM,6 h,12,55,67,2,303,135,168,NPC
LY-456236_10uM_6h,LY-456236,10 uM,6 h,11,109,120,4,1,0,1,NPC
BRD-A19037878_10uM_6h,BRD-A19037878,10 uM,6 h,11,109,120,4,320,170,150,NPC
AGK-2_10uM_6h,AGK-2,10 uM,6 h,11,109,120,4,3,0,3,NPC
KIN001-055_10uM_24h,KIN001-055,10 uM,24 h,11,201,212,4,20,13,7,NPC
BRD-K68336408_10uM_24h,BRD-K68336408,10 uM,24 h,11,192,203,4,191,73,118,NPC
rottlerin_10uM_24h,rottlerin,10 uM,24 h,11,82,93,3,268,100,168,NPC
glycocholic-acid_10uM_24h,glycocholic-acid,10 uM,24 h,10,95,105,3,18,2,16,NPC
KIN001-244_10uM_24h,KIN001-244,10 uM,24 h,10,182,192,4,62,33,29,NPC
ALW-II-49-7_10uM_24h,ALW-II-49-7,10 uM,24 h,10,180,190,4,6,3,3,NPC
methoprene-acid_10uM_24h,methoprene-acid,10 uM,24 h,10,95,105,3,1,1,0,NPC
EHNA_10uM_24h,EHNA,10 uM,24 h,10,98,108,3,2,1,1,NPC
enevalproate_10uM_24h,enevalproate,10 uM,24 h,10,66,76,2,0,0,0,NPC
MK-801_10uM_6h,MK-801,10 uM,6 h,10,54,64,2,11,10,1,NPC
MK-801_10uM_24h,MK-801,10 uM,24 h,10,66,76,2,52,19,33,NPC
enevalproate_10uM_6h,enevalproate,10 uM,6 h,10,54,64,2,0,0,0,NPC
XMD-885_10uM_24h,XMD-885,10 uM,24 h,10,182,192,4,358,157,201,NPC
desmethylclomipramine_10uM_6h,desmethylclomipramine,10 uM,6 h,10,99,109,4,101,28,73,NPC
geranylgeraniol_10uM_24h,geranylgeraniol,10 uM,24 h,9,87,96,3,0,0,0,NPC
KIN001-260_10uM_24h,KIN001-260,10 uM,24 h,9,194,203,3,22,13,9,NPC
C-646_10uM_24h,C-646,10 uM,24 h,9,251,260,3,119,64,55,NPC
UNC-669_10uM_24h,UNC-669,10 uM,24 h,9,251,260,3,0,0,0,NPC
BRD-K04923131_10uM_24h,BRD-K04923131,10 uM,24 h,9,87,96,3,318,111,207,NPC
eicosatetraynoic-acid_10uM_24h,eicosatetraynoic-acid,10 uM,24 h,9,87,96,3,0,0,0,NPC
terreic-acid_10uM_24h,terreic-acid,10 uM,24 h,9,87,96,3,213,63,150,NPC
BRD-A01295252_10uM_24h,BRD-A01295252,10 uM,24 h,9,105,114,3,0,0,0,NPC
desmethylclomipramine_10uM_24h,desmethylclomipramine,10 uM,24 h,9,92,101,4,436,137,299,NPC
BL-077_10uM_24h,BL-077,10 uM,24 h,9,87,96,3,8,1,7,NPC
rifampicin_10uM_24h,rifampicin,10 uM,24 h,9,87,96,3,0,0,0,NPC
SGX-523_10uM_24h,SGX-523,10 uM,24 h,9,194,203,3,13,7,6,NPC
BRD-K54606188_10uM_24h,BRD-K54606188,10 uM,24 h,9,251,260,3,451,221,230,NPC
JQ-1-R_10uM_24h,JQ-1-R,10 uM,24 h,9,251,260,3,92,49,43,NPC
androstenedione_10uM_24h,androstenedione,10 uM,24 h,9,87,96,3,47,15,32,NPC
BRD-K82206012_10uM_24h,BRD-K82206012,10 uM,24 h,9,87,96,3,234,78,156,NPC
BRD-K61463582_10uM_24h,BRD-K61463582,10 uM,24 h,9,87,96,3,168,40,128,NPC
BRD-A96799240_10uM_24h,BRD-A96799240,10 uM,24 h,9,87,96,3,58,14,44,NPC
tunicamycin_10uM_24h,tunicamycin,10 uM,24 h,9,87,96,3,526,202,324,NPC
epoxycholesterol_10uM_24h,epoxycholesterol,10 uM,24 h,9,87,96,3,14,5,9,NPC
GR-206_10uM_24h,GR-206,10 uM,24 h,9,87,96,3,101,32,69,NPC
BRD-K79437791_10uM_24h,BRD-K79437791,10 uM,24 h,9,87,96,3,1,0,1,NPC
ischemin_10uM_24h,ischemin,10 uM,24 h,9,251,260,3,0,0,0,NPC
carbacyclin_10uM_24h,carbacyclin,10 uM,24 h,9,90,99,3,1,1,0,NPC
farnesol_10uM_24h,farnesol,10 uM,24 h,9,87,96,3,16,2,14,NPC
UNC-1215_10uM_24h,UNC-1215,10 uM,24 h,9,251,260,3,3,1,2,NPC
AZD-1480_10uM_24h,AZD-1480,10 uM,24 h,9,194,203,3,155,72,83,NPC
androstanol_10uM_24h,androstanol,10 uM,24 h,9,87,96,3,1,0,1,NPC
BRD-K38756014_10uM_24h,BRD-K38756014,10 uM,24 h,9,87,96,3,1,1,0,NPC
salsolinol_10uM_24h,salsolinol,10 uM,24 h,9,105,114,3,1,0,1,NPC
XMD-1499_10uM_24h,XMD-1499,10 uM,24 h,9,194,203,3,297,139,158,NPC
retinyl_10uM_24h,retinyl,10 uM,24 h,9,87,96,3,0,0,0,NPC
taurocholic-acid_10uM_24h,taurocholic-acid,10 uM,24 h,9,87,96,3,0,0,0,NPC
BRD-K64024097_10uM_24h,BRD-K64024097,10 uM,24 h,9,85,94,3,79,19,60,NPC
kavain_10uM_24h,kavain,10 uM,24 h,9,103,112,3,0,0,0,NPC
BAY-36-7620_10uM_24h,BAY-36-7620,10 uM,24 h,9,105,114,3,1,0,1,NPC
thenoyltrifluoroacetone_10uM_24h,thenoyltrifluoroacetone,10 uM,24 h,9,88,97,3,0,0,0,NPC
LY-2603618_10uM_24h,LY-2603618,10 uM,24 h,9,251,260,3,658,277,381,NPC
CTB_10uM_24h,CTB,10 uM,24 h,9,251,260,3,5,2,3,NPC
KIN001-269_10uM_24h,KIN001-269,10 uM,24 h,9,194,203,3,5,3,2,NPC
RAF-265_10uM_24h,RAF-265,10 uM,24 h,9,194,203,3,269,112,157,NPC
salermide_10uM_6h,salermide,10 uM,6 h,9,57,66,3,2,2,0,NPC
BRD-K75181824_10uM_24h,BRD-K75181824,10 uM,24 h,9,87,96,3,0,0,0,NPC
androstenol_10uM_24h,androstenol,10 uM,24 h,9,87,96,3,0,0,0,NPC
LY-165163_10uM_24h,LY-165163,10 uM,24 h,9,105,114,3,110,50,60,NPC
RG-108_10uM_24h,RG-108,10 uM,24 h,9,251,260,3,0,0,0,NPC
BRD-K78075916_10uM_6h,BRD-K78075916,10 uM,6 h,9,54,63,2,256,80,176,NPC
BRD-A92800748_10uM_24h,BRD-A92800748,10 uM,24 h,9,194,203,3,156,89,67,NPC
BRD-K29983336_10uM_24h,BRD-K29983336,10 uM,24 h,9,194,203,3,2,1,1,NPC
brefeldin-a_10uM_24h,brefeldin-a,10 uM,24 h,9,88,97,3,637,276,361,NPC
taurodeoxycholic-acid_10uM_24h,taurodeoxycholic-acid,10 uM,24 h,9,87,96,3,0,0,0,NPC
TCPOBOP_10uM_24h,TCPOBOP,10 uM,24 h,9,87,96,3,100,41,59,NPC
JNK-IN-5A_10uM_24h,JNK-IN-5A,10 uM,24 h,9,194,203,3,528,224,304,NPC
AZ-20_10uM_24h,AZ-20,10 uM,24 h,9,251,260,3,425,165,260,NPC
BRD-K65411918_10uM_24h,BRD-K65411918,10 uM,24 h,9,87,96,3,0,0,0,NPC
farnesylthioacetic-acid_10uM_24h,farnesylthioacetic-acid,10 uM,24 h,9,90,99,3,0,0,0,NPC
GSK-2334470_10uM_24h,GSK-2334470,10 uM,24 h,9,194,203,3,200,81,119,NPC
BRD-K68144790_10uM_24h,BRD-K68144790,10 uM,24 h,9,87,96,3,0,0,0,NPC
UNC-1215_0.04uM_24h,UNC-1215,0.04 uM,24 h,9,251,260,3,3,0,3,NPC
AZD-1480_0.04uM_24h,AZD-1480,0.04 uM,24 h,9,194,203,3,85,49,36,NPC
KIN001-260_0.04uM_24h,KIN001-260,0.04 uM,24 h,9,194,203,3,1,1,0,NPC
GSK-461364_0.04uM_24h,GSK-461364,0.04 uM,24 h,9,251,260,3,96,44,52,NPC
KIN001-055_0.04uM_24h,KIN001-055,0.04 uM,24 h,9,194,203,3,2,2,0,NPC
anacardic-acid_0.04uM_24h,anacardic-acid,0.04 uM,24 h,9,251,260,3,0,0,0,NPC
NPK76-II-72-1_0.04uM_24h,NPK76-II-72-1,0.04 uM,24 h,9,251,260,3,0,0,0,NPC
garcinol_0.04uM_24h,garcinol,0.04 uM,24 h,9,251,260,3,1,1,0,NPC
KIN001-269_0.04uM_24h,KIN001-269,0.04 uM,24 h,9,194,203,3,0,0,0,NPC
LY-2603618_0.04uM_24h,LY-2603618,0.04 uM,24 h,9,251,260,3,0,0,0,NPC
RAF-265_0.04uM_24h,RAF-265,0.04 uM,24 h,9,194,203,3,20,15,5,NPC
AGK-2_0.04uM_24h,AGK-2,0.04 uM,24 h,9,251,260,3,60,48,12,NPC
chelerythrine_0.04uM_24h,chelerythrine,0.04 uM,24 h,9,194,203,3,113,63,50,NPC
AZD-7762_0.04uM_24h,AZD-7762,0.04 uM,24 h,9,194,203,3,2,1,1,NPC
RG-108_0.04uM_24h,RG-108,0.04 uM,24 h,9,251,260,3,115,71,44,NPC
QL-XI-92_0.04uM_24h,QL-XI-92,0.04 uM,24 h,9,194,203,3,3,2,1,NPC
I-BET-151_0.04uM_24h,I-BET-151,0.04 uM,24 h,9,251,260,3,89,62,27,NPC
KIN001-127_0.04uM_24h,KIN001-127,0.04 uM,24 h,9,194,203,3,2,1,1,NPC
JNK-IN-5A_0.04uM_24h,JNK-IN-5A,0.04 uM,24 h,9,194,203,3,247,100,147,NPC
XMD-1499_0.04uM_24h,XMD-1499,0.04 uM,24 h,9,194,203,3,1,1,0,NPC
BRD-K29983336_0.04uM_24h,BRD-K29983336,0.04 uM,24 h,9,194,203,3,9,6,3,NPC
BRD-K54606188_0.04uM_24h,BRD-K54606188,0.04 uM,24 h,9,251,260,3,214,96,118,NPC
ALW-II-38-3_0.04uM_24h,ALW-II-38-3,0.04 uM,24 h,9,194,203,3,1,1,0,NPC
C-646_0.04uM_24h,C-646,0.04 uM,24 h,9,251,260,3,33,23,10,NPC
GSK-2334470_0.04uM_24h,GSK-2334470,0.04 uM,24 h,9,194,203,3,4,3,1,NPC
UNC-669_0.04uM_24h,UNC-669,0.04 uM,24 h,9,251,260,3,4,3,1,NPC
BRD-A92800748_0.04uM_24h,BRD-A92800748,0.04 uM,24 h,9,194,203,3,0,0,0,NPC
CG-930_0.04uM_24h,CG-930,0.04 uM,24 h,9,194,203,3,0,0,0,NPC
GSK-1070916_0.04uM_24h,GSK-1070916,0.04 uM,24 h,9,251,260,3,40,27,13,NPC
CTB_0.04uM_24h,CTB,0.04 uM,24 h,9,251,260,3,5,3,2,NPC
SGX-523_0.04uM_24h,SGX-523,0.04 uM,24 h,9,194,203,3,2,1,1,NPC
ischemin_0.04uM_24h,ischemin,0.04 uM,24 h,9,251,260,3,41,22,19,NPC
UNC-0638_0.04uM_24h,UNC-0638,0.04 uM,24 h,9,251,260,3,2,2,0,NPC
MLN-8054_0.04uM_24h,MLN-8054,0.04 uM,24 h,9,194,203,3,184,85,99,NPC
KIN001-242_0.04uM_24h,KIN001-242,0.04 uM,24 h,9,194,203,3,0,0,0,NPC
KIN-001-220_0.04uM_24h,KIN-001-220,0.04 uM,24 h,9,194,203,3,16,8,8,NPC
JQ-1-R_0.04uM_24h,JQ-1-R,0.04 uM,24 h,9,251,260,3,1,0,1,NPC
BRD-K55591206_0.04uM_24h,BRD-K55591206,0.04 uM,24 h,9,251,260,3,0,0,0,NPC
XMD-892_0.04uM_24h,XMD-892,0.04 uM,24 h,9,194,203,3,7,6,1,NPC
GSK-429286A_0.12uM_24h,GSK-429286A,0.12 uM,24 h,9,194,203,3,33,21,12,NPC
RAF-265_0.12uM_24h,RAF-265,0.12 uM,24 h,9,194,203,3,158,72,86,NPC
QL-XI-92_0.12uM_24h,QL-XI-92,0.12 uM,24 h,9,194,203,3,1,1,0,NPC
KIN001-269_0.12uM_24h,KIN001-269,0.12 uM,24 h,9,194,203,3,5,5,0,NPC
CTB_0.12uM_24h,CTB,0.12 uM,24 h,9,251,260,3,0,0,0,NPC
UNC-0638_0.12uM_24h,UNC-0638,0.12 uM,24 h,9,251,260,3,6,6,0,NPC
BRD-K55591206_0.12uM_24h,BRD-K55591206,0.12 uM,24 h,9,251,260,3,21,9,12,NPC
AZD-7762_0.12uM_24h,AZD-7762,0.12 uM,24 h,9,194,203,3,36,12,24,NPC
garcinol_0.12uM_24h,garcinol,0.12 uM,24 h,9,251,260,3,0,0,0,NPC
KIN001-260_0.12uM_24h,KIN001-260,0.12 uM,24 h,9,194,203,3,3,2,1,NPC
KIN001-127_0.12uM_24h,KIN001-127,0.12 uM,24 h,9,194,203,3,0,0,0,NPC
UNC-669_0.12uM_24h,UNC-669,0.12 uM,24 h,9,251,260,3,1,1,0,NPC
chelerythrine_0.12uM_24h,chelerythrine,0.12 uM,24 h,9,194,203,3,191,90,101,NPC
XMD-892_0.12uM_24h,XMD-892,0.12 uM,24 h,9,194,203,3,3,1,2,NPC
ALW-II-38-3_0.12uM_24h,ALW-II-38-3,0.12 uM,24 h,9,194,203,3,5,3,2,NPC
NPK76-II-72-1_0.12uM_24h,NPK76-II-72-1,0.12 uM,24 h,9,251,260,3,11,8,3,NPC
JNK-IN-5A_0.12uM_24h,JNK-IN-5A,0.12 uM,24 h,9,194,203,3,287,116,171,NPC
MLN-8054_0.12uM_24h,MLN-8054,0.12 uM,24 h,9,194,203,3,281,116,165,NPC
BRD-K29983336_0.12uM_24h,BRD-K29983336,0.12 uM,24 h,9,194,203,3,5,3,2,NPC
UNC-1215_0.12uM_24h,UNC-1215,0.12 uM,24 h,9,251,260,3,0,0,0,NPC
CG-930_0.12uM_24h,CG-930,0.12 uM,24 h,9,194,203,3,0,0,0,NPC
ischemin_0.12uM_24h,ischemin,0.12 uM,24 h,9,251,260,3,0,0,0,NPC
C-646_0.12uM_24h,C-646,0.12 uM,24 h,9,251,260,3,27,21,6,NPC
AZ-20_0.12uM_24h,AZ-20,0.12 uM,24 h,9,251,260,3,0,0,0,NPC
I-BET-151_0.12uM_24h,I-BET-151,0.12 uM,24 h,9,251,260,3,207,102,105,NPC
RG-108_0.12uM_24h,RG-108,0.12 uM,24 h,9,251,260,3,0,0,0,NPC
GSK-1070916_0.12uM_24h,GSK-1070916,0.12 uM,24 h,9,251,260,3,44,24,20,NPC
KIN001-242_0.12uM_24h,KIN001-242,0.12 uM,24 h,9,194,203,3,1,1,0,NPC
JQ-1-R_0.12uM_24h,JQ-1-R,0.12 uM,24 h,9,251,260,3,1,0,1,NPC
BRD-K54606188_0.12uM_24h,BRD-K54606188,0.12 uM,24 h,9,251,260,3,249,122,127,NPC
AGK-2_0.12uM_24h,AGK-2,0.12 uM,24 h,9,251,260,3,21,18,3,NPC
JWE-035_0.12uM_24h,JWE-035,0.12 uM,24 h,9,194,203,3,9,5,4,NPC
BRD-A92800748_0.12uM_24h,BRD-A92800748,0.12 uM,24 h,9,194,203,3,0,0,0,NPC
GSK-461364_0.12uM_24h,GSK-461364,0.12 uM,24 h,9,251,260,3,126,41,85,NPC
KIN-001-220_0.12uM_24h,KIN-001-220,0.12 uM,24 h,9,194,203,3,16,7,9,NPC
SGX-523_0.12uM_24h,SGX-523,0.12 uM,24 h,9,194,203,3,2,2,0,NPC
KIN001-055_0.12uM_24h,KIN001-055,0.12 uM,24 h,9,194,203,3,2,0,2,NPC
LY-2603618_0.12uM_24h,LY-2603618,0.12 uM,24 h,9,251,260,3,1,0,1,NPC
methylstat_0.12uM_24h,methylstat,0.12 uM,24 h,9,251,260,3,1,1,0,NPC
anacardic-acid_0.12uM_24h,anacardic-acid,0.12 uM,24 h,9,251,260,3,0,0,0,NPC
XMD-1499_0.12uM_24h,XMD-1499,0.12 uM,24 h,9,194,203,3,2,1,1,NPC
GSK-2334470_0.12uM_24h,GSK-2334470,0.12 uM,24 h,9,194,203,3,6,3,3,NPC
KIN001-260_0.37uM_24h,KIN001-260,0.37 uM,24 h,9,194,203,3,9,5,4,NPC
RAF-265_0.37uM_24h,RAF-265,0.37 uM,24 h,9,194,203,3,163,80,83,NPC
ALW-II-38-3_0.37uM_24h,ALW-II-38-3,0.37 uM,24 h,9,194,203,3,1,0,1,NPC
GSK-2334470_0.37uM_24h,GSK-2334470,0.37 uM,24 h,9,194,203,3,35,21,14,NPC
KIN001-055_0.37uM_24h,KIN001-055,0.37 uM,24 h,9,194,203,3,6,4,2,NPC
CTB_0.37uM_24h,CTB,0.37 uM,24 h,9,251,260,3,1,0,1,NPC
QL-XI-92_0.37uM_24h,QL-XI-92,0.37 uM,24 h,9,194,203,3,4,3,1,NPC
GSK-461364_0.37uM_24h,GSK-461364,0.37 uM,24 h,9,251,260,3,107,35,72,NPC
ischemin_0.37uM_24h,ischemin,0.37 uM,24 h,9,251,260,3,1,1,0,NPC
C-646_0.37uM_24h,C-646,0.37 uM,24 h,9,251,260,3,4,3,1,NPC
UNC-0638_0.37uM_24h,UNC-0638,0.37 uM,24 h,9,251,260,3,11,10,1,NPC
BRD-K54606188_0.37uM_24h,BRD-K54606188,0.37 uM,24 h,9,251,260,3,326,144,182,NPC
SGX-523_0.37uM_24h,SGX-523,0.37 uM,24 h,9,194,203,3,0,0,0,NPC
chelerythrine_0.37uM_24h,chelerythrine,0.37 uM,24 h,9,194,203,3,261,85,176,NPC
LY-2603618_0.37uM_24h,LY-2603618,0.37 uM,24 h,9,251,260,3,15,5,10,NPC
methylstat_0.37uM_24h,methylstat,0.37 uM,24 h,9,251,260,3,0,0,0,NPC
AZ-20_0.37uM_24h,AZ-20,0.37 uM,24 h,9,251,260,3,18,10,8,NPC
KIN001-242_0.37uM_24h,KIN001-242,0.37 uM,24 h,9,194,203,3,0,0,0,NPC
anacardic-acid_0.37uM_24h,anacardic-acid,0.37 uM,24 h,9,251,260,3,1,0,1,NPC
UNC-669_0.37uM_24h,UNC-669,0.37 uM,24 h,9,251,260,3,3,3,0,NPC
JNK-IN-5A_0.37uM_24h,JNK-IN-5A,0.37 uM,24 h,9,194,203,3,288,89,199,NPC
AZD-7762_0.37uM_24h,AZD-7762,0.37 uM,24 h,9,194,203,3,5,2,3,NPC
JQ-1-R_0.37uM_24h,JQ-1-R,0.37 uM,24 h,9,251,260,3,5,4,1,NPC
JWE-035_0.37uM_24h,JWE-035,0.37 uM,24 h,9,194,203,3,57,40,17,NPC
XMD-1499_0.37uM_24h,XMD-1499,0.37 uM,24 h,9,194,203,3,45,19,26,NPC
RG-108_0.37uM_24h,RG-108,0.37 uM,24 h,9,251,260,3,4,3,1,NPC
CG-930_0.37uM_24h,CG-930,0.37 uM,24 h,9,194,203,3,38,13,25,NPC
NPK76-II-72-1_0.37uM_24h,NPK76-II-72-1,0.37 uM,24 h,9,251,260,3,3,1,2,NPC
UNC-1215_0.37uM_24h,UNC-1215,0.37 uM,24 h,9,251,260,3,4,1,3,NPC
BRD-A92800748_0.37uM_24h,BRD-A92800748,0.37 uM,24 h,9,194,203,3,0,0,0,NPC
XMD-892_0.37uM_24h,XMD-892,0.37 uM,24 h,9,194,203,3,9,4,5,NPC
garcinol_0.37uM_24h,garcinol,0.37 uM,24 h,9,251,260,3,1,0,1,NPC
GSK-1070916_0.37uM_24h,GSK-1070916,0.37 uM,24 h,9,251,260,3,116,55,61,NPC
AGK-2_0.37uM_24h,AGK-2,0.37 uM,24 h,9,251,260,3,49,31,18,NPC
KIN001-269_0.37uM_24h,KIN001-269,0.37 uM,24 h,9,194,203,3,2,2,0,NPC
AZD-1480_0.37uM_24h,AZD-1480,0.37 uM,24 h,9,194,203,3,7,4,3,NPC
BRD-K55591206_0.37uM_24h,BRD-K55591206,0.37 uM,24 h,9,251,260,3,1,0,1,NPC
KIN001-127_0.37uM_24h,KIN001-127,0.37 uM,24 h,9,194,203,3,0,0,0,NPC
KIN-001-220_0.37uM_24h,KIN-001-220,0.37 uM,24 h,9,194,203,3,65,21,44,NPC
KIN001-269_1.11uM_24h,KIN001-269,1.11 uM,24 h,9,194,203,3,6,4,2,NPC
RG-108_1.11uM_24h,RG-108,1.11 uM,24 h,9,251,260,3,3,2,1,NPC
GSK-2334470_1.11uM_24h,GSK-2334470,1.11 uM,24 h,9,194,203,3,27,14,13,NPC
JQ-1-R_1.11uM_24h,JQ-1-R,1.11 uM,24 h,9,251,260,3,1,1,0,NPC
BRD-K54606188_1.11uM_24h,BRD-K54606188,1.11 uM,24 h,9,251,260,3,414,210,204,NPC
methylstat_1.11uM_24h,methylstat,1.11 uM,24 h,9,251,260,3,5,3,2,NPC
C-646_1.11uM_24h,C-646,1.11 uM,24 h,9,251,260,3,2,2,0,NPC
QL-XI-92_1.11uM_24h,QL-XI-92,1.11 uM,24 h,9,194,203,3,4,3,1,NPC
RAF-265_1.11uM_24h,RAF-265,1.11 uM,24 h,9,194,203,3,146,91,55,NPC
AZD-7762_1.11uM_24h,AZD-7762,1.11 uM,24 h,9,194,203,3,1,0,1,NPC
AZD-1480_1.11uM_24h,AZD-1480,1.11 uM,24 h,9,194,203,3,3,1,2,NPC
GSK-461364_1.11uM_24h,GSK-461364,1.11 uM,24 h,9,251,260,3,127,45,82,NPC
BRD-K55591206_1.11uM_24h,BRD-K55591206,1.11 uM,24 h,9,251,260,3,0,0,0,NPC
GSK-1070916_1.11uM_24h,GSK-1070916,1.11 uM,24 h,9,251,260,3,214,83,131,NPC
KIN-001-220_1.11uM_24h,KIN-001-220,1.11 uM,24 h,9,194,203,3,107,38,69,NPC
AGK-2_1.11uM_24h,AGK-2,1.11 uM,24 h,9,251,260,3,7,7,0,NPC
LY-2603618_1.11uM_24h,LY-2603618,1.11 uM,24 h,9,251,260,3,73,32,41,NPC
KIN001-055_1.11uM_24h,KIN001-055,1.11 uM,24 h,9,194,203,3,255,156,99,NPC
KIN001-260_1.11uM_24h,KIN001-260,1.11 uM,24 h,9,194,203,3,3,2,1,NPC
BRD-K29983336_1.11uM_24h,BRD-K29983336,1.11 uM,24 h,9,194,203,3,2,2,0,NPC
NPK76-II-72-1_1.11uM_24h,NPK76-II-72-1,1.11 uM,24 h,9,251,260,3,137,76,61,NPC
anacardic-acid_1.11uM_24h,anacardic-acid,1.11 uM,24 h,9,251,260,3,5,1,4,NPC
MLN-8054_1.11uM_24h,MLN-8054,1.11 uM,24 h,9,194,203,3,192,86,106,NPC
GSK-429286A_1.11uM_24h,GSK-429286A,1.11 uM,24 h,9,194,203,3,63,29,34,NPC
CG-930_1.11uM_24h,CG-930,1.11 uM,24 h,9,194,203,3,7,6,1,NPC
chelerythrine_1.11uM_24h,chelerythrine,1.11 uM,24 h,9,194,203,3,245,108,137,NPC
CTB_1.11uM_24h,CTB,1.11 uM,24 h,9,251,260,3,2,2,0,NPC
I-BET-151_1.11uM_24h,I-BET-151,1.11 uM,24 h,9,251,260,3,304,166,138,NPC
garcinol_1.11uM_24h,garcinol,1.11 uM,24 h,9,251,260,3,0,0,0,NPC
ALW-II-38-3_1.11uM_24h,ALW-II-38-3,1.11 uM,24 h,9,194,203,3,0,0,0,NPC
XMD-892_1.11uM_24h,XMD-892,1.11 uM,24 h,9,194,203,3,113,56,57,NPC
ischemin_1.11uM_24h,ischemin,1.11 uM,24 h,9,251,260,3,2,0,2,NPC
SGX-523_1.11uM_24h,SGX-523,1.11 uM,24 h,9,194,203,3,1,1,0,NPC
UNC-1215_1.11uM_24h,UNC-1215,1.11 uM,24 h,9,251,260,3,9,3,6,NPC
KIN001-242_1.11uM_24h,KIN001-242,1.11 uM,24 h,9,194,203,3,6,2,4,NPC
BRD-A92800748_1.11uM_24h,BRD-A92800748,1.11 uM,24 h,9,194,203,3,4,2,2,NPC
JNK-IN-5A_1.11uM_24h,JNK-IN-5A,1.11 uM,24 h,9,194,203,3,312,148,164,NPC
AZ-20_1.11uM_24h,AZ-20,1.11 uM,24 h,9,251,260,3,115,53,62,NPC
UNC-669_1.11uM_24h,UNC-669,1.11 uM,24 h,9,251,260,3,1,0,1,NPC
KIN001-127_1.11uM_24h,KIN001-127,1.11 uM,24 h,9,194,203,3,5,4,1,NPC
XMD-1499_1.11uM_24h,XMD-1499,1.11 uM,24 h,9,194,203,3,28,14,14,NPC
UNC-0638_1.11uM_24h,UNC-0638,1.11 uM,24 h,9,251,260,3,11,9,2,NPC
KIN001-242_3.33uM_24h,KIN001-242,3.33 uM,24 h,9,194,203,3,1,1,0,NPC
AZ-20_3.33uM_24h,AZ-20,3.33 uM,24 h,9,251,260,3,270,105,165,NPC
BRD-A92800748_3.33uM_24h,BRD-A92800748,3.33 uM,24 h,9,194,203,3,2,1,1,NPC
ischemin_3.33uM_24h,ischemin,3.33 uM,24 h,9,251,260,3,0,0,0,NPC
CG-930_3.33uM_24h,CG-930,3.33 uM,24 h,9,194,203,3,1,1,0,NPC
LY-2603618_3.33uM_24h,LY-2603618,3.33 uM,24 h,9,251,260,3,163,77,86,NPC
JWE-035_3.33uM_24h,JWE-035,3.33 uM,24 h,9,194,203,3,189,105,84,NPC
KIN001-260_3.33uM_24h,KIN001-260,3.33 uM,24 h,9,194,203,3,0,0,0,NPC
BRD-K54606188_3.33uM_24h,BRD-K54606188,3.33 uM,24 h,9,251,260,3,428,222,206,NPC
MLN-8054_3.33uM_24h,MLN-8054,3.33 uM,24 h,9,194,203,3,133,60,73,NPC
I-BET-151_3.33uM_24h,I-BET-151,3.33 uM,24 h,9,251,260,3,359,183,176,NPC
NPK76-II-72-1_3.33uM_24h,NPK76-II-72-1,3.33 uM,24 h,9,251,260,3,117,60,57,NPC
GSK-461364_3.33uM_24h,GSK-461364,3.33 uM,24 h,9,251,260,3,109,30,79,NPC
KIN001-269_3.33uM_24h,KIN001-269,3.33 uM,24 h,9,194,203,3,20,8,12,NPC
AZD-7762_3.33uM_24h,AZD-7762,3.33 uM,24 h,9,194,203,3,6,2,4,NPC
C-646_3.33uM_24h,C-646,3.33 uM,24 h,9,251,260,3,4,2,2,NPC
UNC-669_3.33uM_24h,UNC-669,3.33 uM,24 h,9,251,260,3,6,3,3,NPC
AGK-2_3.33uM_24h,AGK-2,3.33 uM,24 h,9,251,260,3,247,75,172,NPC
KIN001-127_3.33uM_24h,KIN001-127,3.33 uM,24 h,9,194,203,3,1,1,0,NPC
BRD-K55591206_3.33uM_24h,BRD-K55591206,3.33 uM,24 h,9,251,260,3,5,3,2,NPC
XMD-892_3.33uM_24h,XMD-892,3.33 uM,24 h,9,194,203,3,64,34,30,NPC
SGX-523_3.33uM_24h,SGX-523,3.33 uM,24 h,9,194,203,3,4,1,3,NPC
CTB_3.33uM_24h,CTB,3.33 uM,24 h,9,251,260,3,2,0,2,NPC
ALW-II-38-3_3.33uM_24h,ALW-II-38-3,3.33 uM,24 h,9,194,203,3,23,22,1,NPC
KIN001-055_3.33uM_24h,KIN001-055,3.33 uM,24 h,9,194,203,3,27,14,13,NPC
GSK-2334470_3.33uM_24h,GSK-2334470,3.33 uM,24 h,9,194,203,3,56,31,25,NPC
BRD-K29983336_3.33uM_24h,BRD-K29983336,3.33 uM,24 h,9,194,203,3,4,1,3,NPC
KIN-001-220_3.33uM_24h,KIN-001-220,3.33 uM,24 h,9,194,203,3,286,119,167,NPC
RG-108_3.33uM_24h,RG-108,3.33 uM,24 h,9,251,260,3,0,0,0,NPC
JNK-IN-5A_3.33uM_24h,JNK-IN-5A,3.33 uM,24 h,9,194,203,3,439,200,239,NPC
GSK-429286A_3.33uM_24h,GSK-429286A,3.33 uM,24 h,9,194,203,3,115,54,61,NPC
RAF-265_3.33uM_24h,RAF-265,3.33 uM,24 h,9,194,203,3,132,60,72,NPC
QL-XI-92_3.33uM_24h,QL-XI-92,3.33 uM,24 h,9,194,203,3,14,8,6,NPC
garcinol_3.33uM_24h,garcinol,3.33 uM,24 h,9,251,260,3,0,0,0,NPC
JQ-1-R_3.33uM_24h,JQ-1-R,3.33 uM,24 h,9,251,260,3,0,0,0,NPC
XMD-1499_3.33uM_24h,XMD-1499,3.33 uM,24 h,9,194,203,3,78,44,34,NPC
GSK-1070916_3.33uM_24h,GSK-1070916,3.33 uM,24 h,9,251,260,3,242,98,144,NPC
anacardic-acid_3.33uM_24h,anacardic-acid,3.33 uM,24 h,9,251,260,3,2,2,0,NPC
UNC-1215_3.33uM_24h,UNC-1215,3.33 uM,24 h,9,251,260,3,8,5,3,NPC
UNC-0638_3.33uM_24h,UNC-0638,3.33 uM,24 h,9,251,260,3,18,14,4,NPC
AZD-1480_3.33uM_24h,AZD-1480,3.33 uM,24 h,9,194,203,3,11,0,11,NPC
methylstat_3.33uM_24h,methylstat,3.33 uM,24 h,9,251,260,3,41,20,21,NPC
flumetasone_10uM_24h,flumetasone,10 uM,24 h,8,77,85,2,0,0,0,NPC
clobetasol_10uM_24h,clobetasol,10 uM,24 h,8,76,84,2,0,0,0,NPC
W-7_10uM_24h,W-7,10 uM,24 h,8,98,106,3,2,0,2,NPC
LY-294002_10uM_6h,LY-294002,10 uM,6 h,8,57,65,3,3,1,2,NPC
testosterone_10uM_24h,testosterone,10 uM,24 h,8,77,85,2,26,20,6,NPC
SR-142948_10uM_24h,SR-142948,10 uM,24 h,8,98,106,3,3,2,1,NPC
BRD-K59946561_10uM_24h,BRD-K59946561,10 uM,24 h,8,72,80,3,0,0,0,NPC
BRD-K18135438_10uM_24h,BRD-K18135438,10 uM,24 h,8,76,84,3,0,0,0,NPC
BL-050_10uM_24h,BL-050,10 uM,24 h,8,79,87,3,0,0,0,NPC
OBAA_10uM_24h,OBAA,10 uM,24 h,8,39,47,1,0,0,0,NPC
BRD-K04877770_10uM_24h,BRD-K04877770,10 uM,24 h,8,98,106,3,2,0,2,NPC
NSC-693868_10uM_24h,NSC-693868,10 uM,24 h,8,39,47,1,0,0,0,NPC
GSK-1070916_10uM_24h,GSK-1070916,10 uM,24 h,8,206,214,4,747,295,452,NPC
BRD-K20986251_10uM_24h,BRD-K20986251,10 uM,24 h,8,76,84,3,0,0,0,NPC
SU-4312_10uM_24h,SU-4312,10 uM,24 h,8,79,87,2,0,0,0,NPC
BRD-K91781484_10uM_24h,BRD-K91781484,10 uM,24 h,8,98,106,3,0,0,0,NPC
HO-013_10uM_24h,HO-013,10 uM,24 h,8,77,85,3,14,2,12,NPC
AZ-20_0.04uM_24h,AZ-20,0.04 uM,24 h,8,223,231,3,2,0,2,NPC
methylstat_0.04uM_24h,methylstat,0.04 uM,24 h,8,223,231,3,52,37,15,NPC
JWE-035_0.04uM_24h,JWE-035,0.04 uM,24 h,8,173,181,3,4,3,1,NPC
AZD-1480_0.12uM_24h,AZD-1480,0.12 uM,24 h,8,172,180,3,4,1,3,NPC
MLN-8054_0.37uM_24h,MLN-8054,0.37 uM,24 h,8,172,180,3,166,55,111,NPC
BRD-K29983336_0.37uM_24h,BRD-K29983336,0.37 uM,24 h,8,173,181,3,14,6,8,NPC
I-BET-151_0.37uM_24h,I-BET-151,0.37 uM,24 h,8,223,231,3,253,145,108,NPC
GSK-429286A_0.37uM_24h,GSK-429286A,0.37 uM,24 h,8,172,180,3,15,10,5,NPC
JWE-035_1.11uM_24h,JWE-035,1.11 uM,24 h,8,172,180,3,213,111,102,NPC
chelerythrine_3.33uM_24h,chelerythrine,3.33 uM,24 h,8,172,180,3,672,242,430,NPC
guggulsterone_10uM_24h,guggulsterone,10 uM,24 h,7,69,76,2,11,9,2,NPC
aloisine_10uM_24h,aloisine,10 uM,24 h,7,66,73,2,0,0,0,NPC
UNC-0638_10uM_24h,UNC-0638,10 uM,24 h,7,195,202,3,728,314,414,NPC
H-9_10uM_24h,H-9,10 uM,24 h,7,69,76,2,1,0,1,NPC
AT-7867_10uM_24h,AT-7867,10 uM,24 h,7,153,160,3,475,165,310,NPC
HG-9-91-01_10uM_24h,HG-9-91-01,10 uM,24 h,7,153,160,3,517,209,308,NPC
JWE-035_10uM_24h,JWE-035,10 uM,24 h,7,115,122,3,272,109,163,NPC
MLN-0128_10uM_24h,MLN-0128,10 uM,24 h,7,153,160,3,460,165,295,NPC
KIN001-270_10uM_24h,KIN001-270,10 uM,24 h,7,153,160,3,4,4,0,NPC
fluticasone_10uM_24h,fluticasone,10 uM,24 h,7,66,73,2,37,27,10,NPC
BRD-K09991945_10uM_24h,BRD-K09991945,10 uM,24 h,7,153,160,3,16,13,3,NPC
WZ-7043_10uM_24h,WZ-7043,10 uM,24 h,7,153,160,3,480,182,298,NPC
KIN001-266_10uM_24h,KIN001-266,10 uM,24 h,7,153,160,3,726,312,414,NPC
BMS-509744_10uM_24h,BMS-509744,10 uM,24 h,7,153,160,3,476,178,298,NPC
dichlorobenzamil_10uM_24h,dichlorobenzamil,10 uM,24 h,7,83,90,3,18,8,10,NPC
A-66_10uM_24h,A-66,10 uM,24 h,7,153,160,3,484,153,331,NPC
BMS-509744_0.04uM_24h,BMS-509744,0.04 uM,24 h,7,153,160,3,4,2,2,NPC
HG-14-10-04_0.04uM_24h,HG-14-10-04,0.04 uM,24 h,7,153,160,3,8,5,3,NPC
WZ-7043_0.04uM_24h,WZ-7043,0.04 uM,24 h,7,153,160,3,30,8,22,NPC
AZD-9291_0.04uM_24h,AZD-9291,0.04 uM,24 h,7,153,160,3,3,2,1,NPC
XMD-885_0.04uM_24h,XMD-885,0.04 uM,24 h,7,153,160,3,308,100,208,NPC
MLN-0128_0.04uM_24h,MLN-0128,0.04 uM,24 h,7,153,160,3,314,99,215,NPC
BRD-K68336408_0.04uM_24h,BRD-K68336408,0.04 uM,24 h,7,153,160,3,55,43,12,NPC
BRD-K09991945_0.04uM_24h,BRD-K09991945,0.04 uM,24 h,7,153,160,3,14,7,7,NPC
AZD-4547_0.04uM_24h,AZD-4547,0.04 uM,24 h,7,153,160,3,393,161,232,NPC
KIN001-244_0.04uM_24h,KIN001-244,0.04 uM,24 h,7,153,160,3,65,33,32,NPC
A-66_0.04uM_24h,A-66,0.04 uM,24 h,7,153,160,3,56,19,37,NPC
KIN001-270_0.04uM_24h,KIN001-270,0.04 uM,24 h,7,153,160,3,27,15,12,NPC
KIN001-266_0.04uM_24h,KIN001-266,0.04 uM,24 h,7,153,160,3,39,25,14,NPC
BGT-226_0.04uM_24h,BGT-226,0.04 uM,24 h,7,153,160,3,426,168,258,NPC
AT-7867_0.04uM_24h,AT-7867,0.04 uM,24 h,7,153,160,3,41,27,14,NPC
ALW-II-49-7_0.04uM_24h,ALW-II-49-7,0.04 uM,24 h,7,153,160,3,67,43,24,NPC
HG-9-91-01_0.04uM_24h,HG-9-91-01,0.04 uM,24 h,7,153,160,3,18,8,10,NPC
AZD-9291_0.12uM_24h,AZD-9291,0.12 uM,24 h,7,153,160,3,2,1,1,NPC
KIN001-266_0.12uM_24h,KIN001-266,0.12 uM,24 h,7,153,160,3,1,1,0,NPC
BRD-K68336408_0.12uM_24h,BRD-K68336408,0.12 uM,24 h,7,153,160,3,43,28,15,NPC
BRD-K09991945_0.12uM_24h,BRD-K09991945,0.12 uM,24 h,7,153,160,3,1,1,0,NPC
ALW-II-49-7_0.12uM_24h,ALW-II-49-7,0.12 uM,24 h,7,153,160,3,79,32,47,NPC
HG-9-91-01_0.12uM_24h,HG-9-91-01,0.12 uM,24 h,7,153,160,3,33,15,18,NPC
WZ-7043_0.12uM_24h,WZ-7043,0.12 uM,24 h,7,153,160,3,50,19,31,NPC
BMS-509744_0.12uM_24h,BMS-509744,0.12 uM,24 h,7,153,160,3,5,3,2,NPC
KIN001-244_0.12uM_24h,KIN001-244,0.12 uM,24 h,7,153,160,3,15,9,6,NPC
KIN001-270_0.12uM_24h,KIN001-270,0.12 uM,24 h,7,153,160,3,3,3,0,NPC
MLN-0128_0.12uM_24h,MLN-0128,0.12 uM,24 h,7,153,160,3,329,122,207,NPC
A-66_0.12uM_24h,A-66,0.12 uM,24 h,7,153,160,3,10,7,3,NPC
XMD-885_0.12uM_24h,XMD-885,0.12 uM,24 h,7,153,160,3,175,36,139,NPC
HG-14-10-04_0.12uM_24h,HG-14-10-04,0.12 uM,24 h,7,153,160,3,51,17,34,NPC
AT-7867_0.12uM_24h,AT-7867,0.12 uM,24 h,7,153,160,3,21,11,10,NPC
AZD-4547_0.12uM_24h,AZD-4547,0.12 uM,24 h,7,153,160,3,392,172,220,NPC
KIN001-266_0.37uM_24h,KIN001-266,0.37 uM,24 h,7,153,160,3,1,1,0,NPC
KIN001-270_0.37uM_24h,KIN001-270,0.37 uM,24 h,7,153,160,3,0,0,0,NPC
XMD-885_0.37uM_24h,XMD-885,0.37 uM,24 h,7,153,160,3,163,84,79,NPC
KIN001-244_0.37uM_24h,KIN001-244,0.37 uM,24 h,7,153,160,3,10,10,0,NPC
AT-7867_0.37uM_24h,AT-7867,0.37 uM,24 h,7,153,160,3,32,11,21,NPC
WZ-7043_0.37uM_24h,WZ-7043,0.37 uM,24 h,7,153,160,3,214,51,163,NPC
BMS-509744_0.37uM_24h,BMS-509744,0.37 uM,24 h,7,153,160,3,2,1,1,NPC
BRD-K09991945_0.37uM_24h,BRD-K09991945,0.37 uM,24 h,7,153,160,3,2,0,2,NPC
ALW-II-49-7_0.37uM_24h,ALW-II-49-7,0.37 uM,24 h,7,153,160,3,20,13,7,NPC
A-66_0.37uM_24h,A-66,0.37 uM,24 h,7,153,160,3,5,3,2,NPC
HG-14-10-04_0.37uM_24h,HG-14-10-04,0.37 uM,24 h,7,153,160,3,234,80,154,NPC
AZD-9291_0.37uM_24h,AZD-9291,0.37 uM,24 h,7,153,160,3,5,4,1,NPC
AZD-4547_0.37uM_24h,AZD-4547,0.37 uM,24 h,7,153,160,3,365,141,224,NPC
MLN-0128_0.37uM_24h,MLN-0128,0.37 uM,24 h,7,153,160,3,387,145,242,NPC
BRD-K68336408_1.11uM_24h,BRD-K68336408,1.11 uM,24 h,7,153,160,3,73,17,56,NPC
KIN001-270_1.11uM_24h,KIN001-270,1.11 uM,24 h,7,153,160,3,4,2,2,NPC
BMS-509744_1.11uM_24h,BMS-509744,1.11 uM,24 h,7,153,160,3,1,1,0,NPC
staurosporine_1.11uM_6h,staurosporine,1.11 uM,6 h,7,4,11,2,375,122,253,NPC
AZD-4547_1.11uM_24h,AZD-4547,1.11 uM,24 h,7,153,160,3,378,154,224,NPC
KIN001-244_1.11uM_24h,KIN001-244,1.11 uM,24 h,7,153,160,3,2,1,1,NPC
KIN001-266_1.11uM_24h,KIN001-266,1.11 uM,24 h,7,153,160,3,4,2,2,NPC
ALW-II-49-7_1.11uM_24h,ALW-II-49-7,1.11 uM,24 h,7,153,160,3,3,1,2,NPC
WZ-7043_1.11uM_24h,WZ-7043,1.11 uM,24 h,7,153,160,3,216,76,140,NPC
AT-7867_1.11uM_24h,AT-7867,1.11 uM,24 h,7,153,160,3,21,10,11,NPC
A-66_1.11uM_24h,A-66,1.11 uM,24 h,7,153,160,3,14,4,10,NPC
MLN-0128_1.11uM_24h,MLN-0128,1.11 uM,24 h,7,153,160,3,387,132,255,NPC
AZD-9291_1.11uM_24h,AZD-9291,1.11 uM,24 h,7,153,160,3,14,10,4,NPC
HG-9-91-01_1.11uM_24h,HG-9-91-01,1.11 uM,24 h,7,153,160,3,118,45,73,NPC
BRD-K09991945_1.11uM_24h,BRD-K09991945,1.11 uM,24 h,7,153,160,3,1,1,0,NPC
XMD-885_1.11uM_24h,XMD-885,1.11 uM,24 h,7,153,160,3,13,6,7,NPC
HG-14-10-04_1.11uM_24h,HG-14-10-04,1.11 uM,24 h,7,153,160,3,404,149,255,NPC
MLN-0128_3.33uM_24h,MLN-0128,3.33 uM,24 h,7,153,160,3,404,143,261,NPC
KIN001-266_3.33uM_24h,KIN001-266,3.33 uM,24 h,7,153,160,3,1,1,0,NPC
KIN001-244_3.33uM_24h,KIN001-244,3.33 uM,24 h,7,153,160,3,1,0,1,NPC
AT-7867_3.33uM_24h,AT-7867,3.33 uM,24 h,7,153,160,3,68,41,27,NPC
AZD-4547_3.33uM_24h,AZD-4547,3.33 uM,24 h,7,153,160,3,404,164,240,NPC
KIN001-270_3.33uM_24h,KIN001-270,3.33 uM,24 h,7,153,160,3,5,1,4,NPC
BRD-K09991945_3.33uM_24h,BRD-K09991945,3.33 uM,24 h,7,153,160,3,1,1,0,NPC
XMD-885_3.33uM_24h,XMD-885,3.33 uM,24 h,7,153,160,3,214,98,116,NPC
AZD-9291_3.33uM_24h,AZD-9291,3.33 uM,24 h,7,153,160,3,60,28,32,NPC
HG-9-91-01_3.33uM_24h,HG-9-91-01,3.33 uM,24 h,7,153,160,3,303,137,166,NPC
HG-14-10-04_3.33uM_24h,HG-14-10-04,3.33 uM,24 h,7,153,160,3,585,211,374,NPC
BRD-K68336408_3.33uM_24h,BRD-K68336408,3.33 uM,24 h,7,153,160,3,14,6,8,NPC
BMS-509744_3.33uM_24h,BMS-509744,3.33 uM,24 h,7,153,160,3,2,2,0,NPC
IWP-2_10uM_6h,IWP-2,10 uM,6 h,6,55,61,2,0,0,0,NPC
BRD-K23875128_10uM_6h,BRD-K23875128,10 uM,6 h,6,55,61,2,0,0,0,NPC
BG-1019_10uM_6h,BG-1019,10 uM,6 h,6,55,61,2,0,0,0,NPC
BG-1030_10uM_6h,BG-1030,10 uM,6 h,6,55,61,2,214,94,120,NPC
BRD-K20986251_10uM_6h,BRD-K20986251,10 uM,6 h,6,55,61,2,0,0,0,NPC
dihydrocapsaicin_10uM_24h,dihydrocapsaicin,10 uM,24 h,6,58,64,2,184,85,99,NPC
BRD-K75181824_10uM_6h,BRD-K75181824,10 uM,6 h,6,55,61,2,0,0,0,NPC
BRD-K23875128_10uM_24h,BRD-K23875128,10 uM,24 h,6,58,64,2,201,82,119,NPC
rifampicin_10uM_6h,rifampicin,10 uM,6 h,6,55,61,2,11,6,5,NPC
BRD-K51490254_10uM_6h,BRD-K51490254,10 uM,6 h,6,55,61,2,0,0,0,NPC
BRD-K31342827_10uM_24h,BRD-K31342827,10 uM,24 h,6,58,64,2,477,189,288,NPC
BG-1022_10uM_24h,BG-1022,10 uM,24 h,6,58,64,2,91,20,71,NPC
BRD-K01192156_10uM_6h,BRD-K01192156,10 uM,6 h,6,55,61,2,0,0,0,NPC
oxamflatin_10uM_6h,oxamflatin,10 uM,6 h,6,55,61,2,186,74,112,NPC
BG-1007_10uM_6h,BG-1007,10 uM,6 h,6,55,61,2,191,90,101,NPC
BRD-K31342827_10uM_6h,BRD-K31342827,10 uM,6 h,6,55,61,2,186,59,127,NPC
BRD-K01192156_10uM_24h,BRD-K01192156,10 uM,24 h,6,58,64,2,0,0,0,NPC
JS-K_10uM_6h,JS-K,10 uM,6 h,6,55,61,2,314,118,196,NPC
BRD-K59946561_10uM_6h,BRD-K59946561,10 uM,6 h,6,55,61,2,0,0,0,NPC
BRD-K83872150_10uM_6h,BRD-K83872150,10 uM,6 h,6,55,61,2,2,1,1,NPC
BRD-K35923252_10uM_24h,BRD-K35923252,10 uM,24 h,6,58,64,2,408,157,251,NPC
BRD-K65411918_10uM_6h,BRD-K65411918,10 uM,6 h,6,55,61,2,3,0,3,NPC
taurodeoxycholic-acid_10uM_6h,taurodeoxycholic-acid,10 uM,6 h,6,55,61,2,0,0,0,NPC
BG-1024_10uM_6h,BG-1024,10 uM,6 h,6,55,61,2,32,11,21,NPC
HDAC1-selective_10uM_6h,HDAC1-selective,10 uM,6 h,6,55,61,2,12,4,8,NPC
EMF-sumo1-10_10uM_24h,EMF-sumo1-10,10 uM,24 h,6,58,64,2,8,0,8,NPC
EMF-sumo1-4_10uM_24h,EMF-sumo1-4,10 uM,24 h,6,29,35,1,1,0,1,NPC
BG-1032_10uM_6h,BG-1032,10 uM,6 h,6,55,61,2,94,31,63,NPC
methoprene-acid_10uM_6h,methoprene-acid,10 uM,6 h,6,55,61,2,0,0,0,NPC
penitrem-a_10uM_6h,penitrem-a,10 uM,6 h,6,55,61,2,74,38,36,NPC
BRD-A08027849_10uM_24h,BRD-A08027849,10 uM,24 h,6,58,64,2,39,2,37,NPC
isonicotinohydroxamic-acid_10uM_24h,isonicotinohydroxamic-acid,10 uM,24 h,6,58,64,2,52,8,44,NPC
BRD-A42994615_10uM_6h,BRD-A42994615,10 uM,6 h,6,55,61,2,18,9,9,NPC
EHNA_10uM_6h,EHNA,10 uM,6 h,6,55,61,2,0,0,0,NPC
RAN-07_10uM_24h,RAN-07,10 uM,24 h,6,58,64,2,0,0,0,NPC
BG-1016_10uM_6h,BG-1016,10 uM,6 h,6,55,61,2,29,7,22,NPC
BRD-K79437791_10uM_6h,BRD-K79437791,10 uM,6 h,6,55,61,2,9,7,2,NPC
BG-1007_10uM_24h,BG-1007,10 uM,24 h,6,58,64,2,496,223,273,NPC
isonicotinohydroxamic-acid_10uM_6h,isonicotinohydroxamic-acid,10 uM,6 h,6,55,61,2,1,1,0,NPC
ISOX_10uM_6h,ISOX,10 uM,6 h,6,55,61,2,159,78,81,NPC
farnesylthioacetic-acid_10uM_6h,farnesylthioacetic-acid,10 uM,6 h,6,55,61,2,1,1,0,NPC
triacetylresveratrol_10uM_24h,triacetylresveratrol,10 uM,24 h,6,58,64,2,374,112,262,NPC
z-guggulsterone_10uM_6h,z-guggulsterone,10 uM,6 h,6,55,61,2,7,2,5,NPC
BRD-K32307229_10uM_24h,BRD-K32307229,10 uM,24 h,6,58,64,2,98,35,63,NPC
BRD-K75516118_10uM_6h,BRD-K75516118,10 uM,6 h,6,55,61,2,2,1,1,NPC
BRD-A26595446_10uM_24h,BRD-A26595446,10 uM,24 h,6,29,35,1,0,0,0,NPC
CTPB_10uM_24h,CTPB,10 uM,24 h,6,58,64,2,0,0,0,NPC
butyrolactone_10uM_6h,butyrolactone,10 uM,6 h,6,55,61,2,0,0,0,NPC
BRD-K51490254_10uM_24h,BRD-K51490254,10 uM,24 h,6,58,64,2,22,5,17,NPC
BG-1012_10uM_6h,BG-1012,10 uM,6 h,6,55,61,2,0,0,0,NPC
BG-1029_10uM_24h,BG-1029,10 uM,24 h,6,58,64,2,558,273,285,NPC
QS-11_10uM_24h,QS-11,10 uM,24 h,6,58,64,2,79,21,58,NPC
BML-210_10uM_6h,BML-210,10 uM,6 h,6,55,61,2,220,82,138,NPC
ketocholesterol_10uM_24h,ketocholesterol,10 uM,24 h,6,58,64,2,111,50,61,NPC
BRD-K99667445_10uM_24h,BRD-K99667445,10 uM,24 h,6,58,64,2,36,7,29,NPC
BRD-K99667445_10uM_6h,BRD-K99667445,10 uM,6 h,6,55,61,2,13,3,10,NPC
BG-1014_10uM_6h,BG-1014,10 uM,6 h,6,55,61,2,0,0,0,NPC
BRD-K36162096_10uM_6h,BRD-K36162096,10 uM,6 h,6,55,61,2,0,0,0,NPC
NCH-51_10uM_6h,NCH-51,10 uM,6 h,6,55,61,2,144,56,88,NPC
paxilline_10uM_24h,paxilline,10 uM,24 h,6,58,64,2,105,37,68,NPC
BG-1018_10uM_6h,BG-1018,10 uM,6 h,6,55,61,2,21,13,8,NPC
EMF-sumo1-5_10uM_24h,EMF-sumo1-5,10 uM,24 h,6,29,35,1,0,0,0,NPC
BG-1013_10uM_24h,BG-1013,10 uM,24 h,6,58,64,2,25,6,19,NPC
rottlerin_10uM_6h,rottlerin,10 uM,6 h,6,55,61,2,44,16,28,NPC
BRD-K89912164_10uM_6h,BRD-K89912164,10 uM,6 h,6,55,61,2,0,0,0,NPC
dihydrocapsaicin_10uM_6h,dihydrocapsaicin,10 uM,6 h,6,55,61,2,0,0,0,NPC
carbacyclin_10uM_6h,carbacyclin,10 uM,6 h,6,55,61,2,21,4,17,NPC
PLX-4720_10uM_24h,PLX-4720,10 uM,24 h,6,56,62,2,29,13,16,NPC
EMF-sumo1-12_10uM_24h,EMF-sumo1-12,10 uM,24 h,6,29,35,1,0,0,0,NPC
BRD-K64729807_10uM_24h,BRD-K64729807,10 uM,24 h,6,58,64,2,0,0,0,NPC
BRD-K47503321_10uM_24h,BRD-K47503321,10 uM,24 h,6,58,64,2,352,137,215,NPC
thenoyltrifluoroacetone_10uM_6h,thenoyltrifluoroacetone,10 uM,6 h,6,55,61,2,0,0,0,NPC
BL-077_10uM_6h,BL-077,10 uM,6 h,6,55,61,2,0,0,0,NPC
androstanol_10uM_6h,androstanol,10 uM,6 h,6,55,61,2,0,0,0,NPC
ionomycin_10uM_6h,ionomycin,10 uM,6 h,6,55,61,2,224,62,162,NPC
terreic-acid_10uM_6h,terreic-acid,10 uM,6 h,6,55,61,2,29,17,12,NPC
C2-dihydroceramide_10uM_24h,C2-dihydroceramide,10 uM,24 h,6,58,64,2,149,44,105,NPC
cardamonin_10uM_24h,cardamonin,10 uM,24 h,6,58,64,2,61,16,45,NPC
butyrolactone_10uM_24h,butyrolactone,10 uM,24 h,6,58,64,2,201,55,146,NPC
salermide_10uM_24h,salermide,10 uM,24 h,6,58,64,2,0,0,0,NPC
EMF-sumo1-2_10uM_24h,EMF-sumo1-2,10 uM,24 h,6,29,35,1,0,0,0,NPC
BG-1006_10uM_6h,BG-1006,10 uM,6 h,6,55,61,2,150,61,89,NPC
BG-1021_10uM_6h,BG-1021,10 uM,6 h,6,55,61,2,2,0,2,NPC
carnosol_10uM_24h,carnosol,10 uM,24 h,6,58,64,2,5,3,2,NPC
EMF-sumo1-8_10uM_24h,EMF-sumo1-8,10 uM,24 h,6,29,35,1,0,0,0,NPC
z-guggulsterone_10uM_24h,z-guggulsterone,10 uM,24 h,6,58,64,2,8,3,5,NPC
Val-Val-Val_10uM_24h,Val-Val-Val,10 uM,24 h,6,58,64,2,24,4,20,NPC
IM-12_10uM_6h,IM-12,10 uM,6 h,6,55,61,2,0,0,0,NPC
alitretinoin_10uM_6h,alitretinoin,10 uM,6 h,6,55,61,2,2,2,0,NPC
usnic-acid_10uM_6h,usnic-acid,10 uM,6 h,6,55,61,2,35,11,24,NPC
C2-dihydroceramide_10uM_6h,C2-dihydroceramide,10 uM,6 h,6,55,61,2,113,36,77,NPC
dithiothreitol_10uM_24h,dithiothreitol,10 uM,24 h,6,58,64,2,7,2,5,NPC
antimycin-a_10uM_24h,antimycin-a,10 uM,24 h,6,58,64,2,36,17,19,NPC
BRD-K67808578_10uM_24h,BRD-K67808578,10 uM,24 h,6,56,62,2,0,0,0,NPC
rotenone_10uM_24h,rotenone,10 uM,24 h,6,58,64,2,86,23,63,NPC
BRD-K81647657_10uM_6h,BRD-K81647657,10 uM,6 h,6,55,61,2,0,0,0,NPC
BG-1017_10uM_6h,BG-1017,10 uM,6 h,6,55,61,2,2,2,0,NPC
BG-1030_10uM_24h,BG-1030,10 uM,24 h,6,58,64,2,554,238,316,NPC
BRD-K68144790_10uM_6h,BRD-K68144790,10 uM,6 h,6,55,61,2,1,0,1,NPC
BG-1025_10uM_24h,BG-1025,10 uM,24 h,6,58,64,2,360,137,223,NPC
gingerol_10uM_24h,gingerol,10 uM,24 h,6,58,64,2,5,1,4,NPC
penitrem-a_10uM_24h,penitrem-a,10 uM,24 h,6,63,69,2,78,34,44,NPC
BG-1018_10uM_24h,BG-1018,10 uM,24 h,6,58,64,2,2,0,2,NPC
diarylsulfonesulfonamide_10uM_24h,diarylsulfonesulfonamide,10 uM,24 h,6,58,64,2,0,0,0,NPC
BG-1009_10uM_24h,BG-1009,10 uM,24 h,6,58,64,2,90,30,60,NPC
BRD-K04923131_10uM_6h,BRD-K04923131,10 uM,6 h,6,55,61,2,126,37,89,NPC
BG-1015_10uM_24h,BG-1015,10 uM,24 h,6,58,64,2,0,0,0,NPC
BML-286_10uM_6h,BML-286,10 uM,6 h,6,55,61,2,4,1,3,NPC
BRD-A57107094_10uM_24h,BRD-A57107094,10 uM,24 h,6,56,62,2,1,1,0,NPC
trehalose_10uM_6h,trehalose,10 uM,6 h,6,55,61,2,0,0,0,NPC
taurocholic-acid_10uM_6h,taurocholic-acid,10 uM,6 h,6,55,61,2,0,0,0,NPC
BRD-K81647657_10uM_24h,BRD-K81647657,10 uM,24 h,6,58,64,2,8,5,3,NPC
benzohydroxamic-acid_10uM_24h,benzohydroxamic-acid,10 uM,24 h,6,58,64,2,13,3,10,NPC
BG-1015_10uM_6h,BG-1015,10 uM,6 h,6,55,61,2,0,0,0,NPC
BG-1005_10uM_6h,BG-1005,10 uM,6 h,6,55,61,2,170,88,82,NPC
purpurogallin_10uM_6h,purpurogallin,10 uM,6 h,6,55,61,2,3,1,2,NPC
harmine_10uM_24h,harmine,10 uM,24 h,6,58,64,2,41,17,24,NPC
BML-278_10uM_6h,BML-278,10 uM,6 h,6,55,61,2,2,1,1,NPC
NCI-16221_10uM_6h,NCI-16221,10 uM,6 h,6,55,61,2,0,0,0,NPC
valproxam_10uM_6h,valproxam,10 uM,6 h,6,55,61,2,0,0,0,NPC
NCI-16221_10uM_24h,NCI-16221,10 uM,24 h,6,58,64,2,6,3,3,NPC
ITSA-1_10uM_24h,ITSA-1,10 uM,24 h,6,58,64,2,21,4,17,NPC
BRD-U61360806_10uM_24h,BRD-U61360806,10 uM,24 h,6,58,64,2,3,1,2,NPC
flavanone_10uM_24h,flavanone,10 uM,24 h,6,58,64,2,8,1,7,NPC
BG-1032_10uM_24h,BG-1032,10 uM,24 h,6,58,64,2,357,124,233,NPC
BG-1028_10uM_24h,BG-1028,10 uM,24 h,6,58,64,2,571,266,305,NPC
BAY-K8644_10uM_6h,BAY-K8644,10 uM,6 h,6,55,61,2,0,0,0,NPC
BRD-A96799240_10uM_6h,BRD-A96799240,10 uM,6 h,6,55,61,2,2,2,0,NPC
ISOX_10uM_24h,ISOX,10 uM,24 h,6,58,64,2,533,229,304,NPC
BRD-K99636700_10uM_6h,BRD-K99636700,10 uM,6 h,6,55,61,2,70,32,38,NPC
PMSF_10uM_24h,PMSF,10 uM,24 h,6,58,64,2,55,12,43,NPC
itdac-1_10uM_6h,itdac-1,10 uM,6 h,6,55,61,2,11,3,8,NPC
QS-11_10uM_6h,QS-11,10 uM,6 h,6,55,61,2,4,1,3,NPC
BRD-K95760042_10uM_24h,BRD-K95760042,10 uM,24 h,6,56,62,2,5,1,4,NPC
BG-1023_10uM_24h,BG-1023,10 uM,24 h,6,58,64,2,109,30,79,NPC
tunicamycin_10uM_6h,tunicamycin,10 uM,6 h,6,55,61,2,33,22,11,NPC
dithiothreitol_10uM_6h,dithiothreitol,10 uM,6 h,6,55,61,2,0,0,0,NPC
BG-1022_10uM_6h,BG-1022,10 uM,6 h,6,55,61,2,1,1,0,NPC
usnic-acid_10uM_24h,usnic-acid,10 uM,24 h,6,58,64,2,0,0,0,NPC
purpurogallin_10uM_24h,purpurogallin,10 uM,24 h,6,58,64,2,146,35,111,NPC
BRD-K61463582_10uM_6h,BRD-K61463582,10 uM,6 h,6,55,61,2,3,2,1,NPC
BRD-K54729176_10uM_24h,BRD-K54729176,10 uM,24 h,6,58,64,2,48,22,26,NPC
BRD-K86570333_10uM_24h,BRD-K86570333,10 uM,24 h,6,58,64,2,2,1,1,NPC
BRD-K89997465_10uM_24h,BRD-K89997465,10 uM,24 h,6,57,63,2,202,72,130,NPC
BG-1029_10uM_6h,BG-1029,10 uM,6 h,6,55,61,2,168,80,88,NPC
BRD-K32307229_10uM_6h,BRD-K32307229,10 uM,6 h,6,55,61,2,135,56,79,NPC
BRD-A42994615_10uM_24h,BRD-A42994615,10 uM,24 h,6,58,64,2,0,0,0,NPC
BML-266_10uM_24h,BML-266,10 uM,24 h,6,58,64,2,14,2,12,NPC
BG-1026_10uM_24h,BG-1026,10 uM,24 h,6,58,64,2,526,222,304,NPC
BG-1016_10uM_24h,BG-1016,10 uM,24 h,6,58,64,2,91,29,62,NPC
bafilomycin_10uM_6h,bafilomycin,10 uM,6 h,6,55,61,2,4,4,0,NPC
BG-1011_10uM_6h,BG-1011,10 uM,6 h,6,55,61,2,10,6,4,NPC
BRD-K18135438_10uM_6h,BRD-K18135438,10 uM,6 h,6,55,61,2,37,6,31,NPC
BRD-K97808269_10uM_24h,BRD-K97808269,10 uM,24 h,6,58,64,2,255,109,146,NPC
GR-206_10uM_6h,GR-206,10 uM,6 h,6,55,61,2,12,5,7,NPC
BRD-K38756014_10uM_6h,BRD-K38756014,10 uM,6 h,6,55,61,2,0,0,0,NPC
BRD-K04722205_10uM_24h,BRD-K04722205,10 uM,24 h,6,58,64,2,1,0,1,NPC
CCT036477_10uM_6h,CCT036477,10 uM,6 h,6,55,61,2,87,25,62,NPC
BRD-K64729807_10uM_6h,BRD-K64729807,10 uM,6 h,6,55,61,2,1,0,1,NPC
BRD-K82206012_10uM_6h,BRD-K82206012,10 uM,6 h,6,55,61,2,2,2,0,NPC
BG-1017_10uM_24h,BG-1017,10 uM,24 h,6,58,64,2,6,1,5,NPC
rotenone_10uM_6h,rotenone,10 uM,6 h,6,55,61,2,20,9,11,NPC
NCH-51_10uM_24h,NCH-51,10 uM,24 h,6,58,64,2,492,203,289,NPC
IM-12_10uM_24h,IM-12,10 uM,24 h,6,58,64,2,142,37,105,NPC
BG-1008_10uM_6h,BG-1008,10 uM,6 h,6,55,61,2,161,74,87,NPC
HDAC1-selective_10uM_24h,HDAC1-selective,10 uM,24 h,6,58,64,2,205,70,135,NPC
eicosatetraynoic-acid_10uM_6h,eicosatetraynoic-acid,10 uM,6 h,6,55,61,2,22,5,17,NPC
BRD-K99636700_10uM_24h,BRD-K99636700,10 uM,24 h,6,58,64,2,388,145,243,NPC
BRD-K05396879_10uM_6h,BRD-K05396879,10 uM,6 h,6,55,61,2,22,16,6,NPC
farnesol_10uM_6h,farnesol,10 uM,6 h,6,55,61,2,0,0,0,NPC
PMSF_10uM_6h,PMSF,10 uM,6 h,6,55,61,2,0,0,0,NPC
BG-1023_10uM_6h,BG-1023,10 uM,6 h,6,55,61,2,13,10,3,NPC
BG-1012_10uM_24h,BG-1012,10 uM,24 h,6,58,64,2,3,0,3,NPC
BG-1009_10uM_6h,BG-1009,10 uM,6 h,6,55,61,2,2,0,2,NPC
BG-1031_10uM_6h,BG-1031,10 uM,6 h,6,55,61,2,5,2,3,NPC
carnosol_10uM_6h,carnosol,10 uM,6 h,6,55,61,2,8,3,5,NPC
AS-605240_10uM_6h,AS-605240,10 uM,6 h,6,55,61,2,4,1,3,NPC
flavanone_10uM_6h,flavanone,10 uM,6 h,6,55,61,2,0,0,0,NPC
BRD-K62459624_10uM_24h,BRD-K62459624,10 uM,24 h,6,58,64,2,166,52,114,NPC
BL-050_10uM_6h,BL-050,10 uM,6 h,6,55,61,2,1,1,0,NPC
paxilline_10uM_6h,paxilline,10 uM,6 h,6,55,61,2,2,2,0,NPC
BG-1026_10uM_6h,BG-1026,10 uM,6 h,6,55,61,2,135,62,73,NPC
BRD-K55591206_10uM_6h,BRD-K55591206,10 uM,6 h,6,55,61,2,0,0,0,NPC
F-1566-0341_10uM_24h,F-1566-0341,10 uM,24 h,6,56,62,2,0,0,0,NPC
BAY-K8644_10uM_24h,BAY-K8644,10 uM,24 h,6,58,64,2,65,6,59,NPC
MC-1293_10uM_6h,MC-1293,10 uM,6 h,6,55,61,2,0,0,0,NPC
diarylsulfonesulfonamide_10uM_6h,diarylsulfonesulfonamide,10 uM,6 h,6,55,61,2,1,0,1,NPC
BRD-K47503321_10uM_6h,BRD-K47503321,10 uM,6 h,6,55,61,2,38,15,23,NPC
BG-1025_10uM_6h,BG-1025,10 uM,6 h,6,55,61,2,139,75,64,NPC
ketocholesterol_10uM_6h,ketocholesterol,10 uM,6 h,6,55,61,2,0,0,0,NPC
BRD-K39096267_10uM_6h,BRD-K39096267,10 uM,6 h,6,55,61,2,27,18,9,NPC
trehalose_10uM_24h,trehalose,10 uM,24 h,6,58,64,2,79,19,60,NPC
EMF-sumo1-1_10uM_24h,EMF-sumo1-1,10 uM,24 h,6,29,35,1,1,1,0,NPC
Val-Val-Val_10uM_6h,Val-Val-Val,10 uM,6 h,6,55,61,2,0,0,0,NPC
BG-1028_10uM_6h,BG-1028,10 uM,6 h,6,55,61,2,168,85,83,NPC
BRD-K86570333_10uM_6h,BRD-K86570333,10 uM,6 h,6,55,61,2,0,0,0,NPC
BG-1020_10uM_24h,BG-1020,10 uM,24 h,6,58,64,2,4,0,4,NPC
BRD-K54729176_10uM_6h,BRD-K54729176,10 uM,6 h,6,55,61,2,26,13,13,NPC
BRD-K27332342_10uM_24h,BRD-K27332342,10 uM,24 h,6,58,64,2,53,25,28,NPC
BG-1014_10uM_24h,BG-1014,10 uM,24 h,6,58,64,2,145,49,96,NPC
garcinol_10uM_6h,garcinol,10 uM,6 h,6,55,61,2,0,0,0,NPC
EMF-sumo1-7_10uM_24h,EMF-sumo1-7,10 uM,24 h,6,29,35,1,1,0,1,NPC
AZD-4547_10uM_24h,AZD-4547,10 uM,24 h,6,131,137,2,739,290,449,NPC
BG-1019_10uM_24h,BG-1019,10 uM,24 h,6,58,64,2,5,5,0,NPC
BRD-K37846922_10uM_6h,BRD-K37846922,10 uM,6 h,6,55,61,2,0,0,0,NPC
IQ1_10uM_6h,IQ1,10 uM,6 h,6,55,61,2,13,2,11,NPC
BRD-K36162096_10uM_24h,BRD-K36162096,10 uM,24 h,6,58,64,2,0,0,0,NPC
KIN-001-220_10uM_24h,KIN-001-220,10 uM,24 h,6,93,99,2,318,125,193,NPC
AS-605240_10uM_24h,AS-605240,10 uM,24 h,6,58,64,2,0,0,0,NPC
BG-1010_10uM_24h,BG-1010,10 uM,24 h,6,58,64,2,566,185,381,NPC
BG-1020_10uM_6h,BG-1020,10 uM,6 h,6,55,61,2,1,1,0,NPC
BOX-5_10uM_24h,BOX-5,10 uM,24 h,6,58,64,2,1,0,1,NPC
bafilomycin_10uM_24h,bafilomycin,10 uM,24 h,6,58,64,2,224,74,150,NPC
epoxycholesterol_10uM_6h,epoxycholesterol,10 uM,6 h,6,55,61,2,6,0,6,NPC
ST-4062971_10uM_24h,ST-4062971,10 uM,24 h,6,29,35,1,118,40,78,NPC
BG-1027_10uM_24h,BG-1027,10 uM,24 h,6,58,64,2,519,228,291,NPC
BRD-K61894884_10uM_6h,BRD-K61894884,10 uM,6 h,6,55,61,2,0,0,0,NPC
valproxam_10uM_24h,valproxam,10 uM,24 h,6,58,64,2,250,80,170,NPC
MC-1293_10uM_24h,MC-1293,10 uM,24 h,6,58,64,2,0,0,0,NPC
BRD-K27332342_10uM_6h,BRD-K27332342,10 uM,6 h,6,55,61,2,8,6,2,NPC
BRD-K61894884_10uM_24h,BRD-K61894884,10 uM,24 h,6,58,64,2,188,53,135,NPC
isonicotinamide_10uM_6h,isonicotinamide,10 uM,6 h,6,55,61,2,3,0,3,NPC
BG-1010_10uM_6h,BG-1010,10 uM,6 h,6,55,61,2,30,18,12,NPC
geranylgeraniol_10uM_6h,geranylgeraniol,10 uM,6 h,6,55,61,2,35,23,12,NPC
BOX-5_10uM_6h,BOX-5,10 uM,6 h,6,55,61,2,0,0,0,NPC
androstenol_10uM_6h,androstenol,10 uM,6 h,6,55,61,2,54,24,30,NPC
aminoresveratrol_10uM_24h,aminoresveratrol,10 uM,24 h,6,58,64,2,245,65,180,NPC
BRD-K75516118_10uM_24h,BRD-K75516118,10 uM,24 h,6,58,64,2,1,1,0,NPC
BRD-K83872150_10uM_24h,BRD-K83872150,10 uM,24 h,6,58,64,2,122,43,79,NPC
CTPB_10uM_6h,CTPB,10 uM,6 h,6,55,61,2,4,1,3,NPC
BG-1006_10uM_24h,BG-1006,10 uM,24 h,6,58,64,2,459,219,240,NPC
BRD-K64024097_10uM_6h,BRD-K64024097,10 uM,6 h,6,55,61,2,1,1,0,NPC
BG-1021_10uM_24h,BG-1021,10 uM,24 h,6,58,64,2,119,33,86,NPC
itdac-1_10uM_24h,itdac-1,10 uM,24 h,6,58,64,2,1,1,0,NPC
BRD-U61360806_10uM_6h,BRD-U61360806,10 uM,6 h,6,55,61,2,0,0,0,NPC
benzohydroxamic-acid_10uM_6h,benzohydroxamic-acid,10 uM,6 h,6,55,61,2,1,0,1,NPC
isonicotinamide_10uM_24h,isonicotinamide,10 uM,24 h,6,58,64,2,210,52,158,NPC
BG-1008_10uM_24h,BG-1008,10 uM,24 h,6,58,64,2,415,189,226,NPC
anacardic-acid_10uM_6h,anacardic-acid,10 uM,6 h,6,55,61,2,42,24,18,NPC
BG-1031_10uM_24h,BG-1031,10 uM,24 h,6,58,64,2,357,133,224,NPC
BML-210_10uM_24h,BML-210,10 uM,24 h,6,58,64,2,130,52,78,NPC
oxamflatin_10uM_24h,oxamflatin,10 uM,24 h,6,58,64,2,487,235,252,NPC
BRD-K39096267_10uM_24h,BRD-K39096267,10 uM,24 h,6,58,64,2,180,78,102,NPC
BRD-K35307346_10uM_24h,BRD-K35307346,10 uM,24 h,6,58,64,2,65,40,25,NPC
BRD-A95074085_10uM_24h,BRD-A95074085,10 uM,24 h,6,58,64,2,0,0,0,NPC
niguldipine_10uM_6h,niguldipine,10 uM,6 h,6,55,61,2,11,10,1,NPC
BML-286_10uM_24h,BML-286,10 uM,24 h,6,58,64,2,68,9,59,NPC
retinyl_10uM_6h,retinyl,10 uM,6 h,6,55,61,2,1,1,0,NPC
lithium-chloride_10uM_6h,lithium-chloride,10 uM,6 h,6,55,61,2,9,2,7,NPC
glycocholic-acid_10uM_6h,glycocholic-acid,10 uM,6 h,6,55,61,2,0,0,0,NPC
BRD-K97808269_10uM_6h,BRD-K97808269,10 uM,6 h,6,55,61,2,0,0,0,NPC
cardamonin_10uM_6h,cardamonin,10 uM,6 h,6,55,61,2,2,1,1,NPC
IWP-2_10uM_24h,IWP-2,10 uM,24 h,6,58,64,2,6,2,4,NPC
BRD-K35307346_10uM_6h,BRD-K35307346,10 uM,6 h,6,55,61,2,23,10,13,NPC
AZD-6482_10uM_24h,AZD-6482,10 uM,24 h,6,29,35,1,5,0,5,NPC
BG-1027_10uM_6h,BG-1027,10 uM,6 h,6,55,61,2,189,80,109,NPC
harmine_10uM_6h,harmine,10 uM,6 h,6,55,61,2,37,10,27,NPC
BG-1013_10uM_6h,BG-1013,10 uM,6 h,6,55,61,2,0,0,0,NPC
lithium-chloride_10uM_24h,lithium-chloride,10 uM,24 h,6,58,64,2,7,2,5,NPC
BML-278_10uM_24h,BML-278,10 uM,24 h,6,58,64,2,348,125,223,NPC
ITSA-1_10uM_6h,ITSA-1,10 uM,6 h,6,55,61,2,3,0,3,NPC
androstenedione_10uM_6h,androstenedione,10 uM,6 h,6,55,61,2,0,0,0,NPC
EMF-sumo1-3_10uM_24h,EMF-sumo1-3,10 uM,24 h,6,29,35,1,6,0,6,NPC
BRD-K89912164_10uM_24h,BRD-K89912164,10 uM,24 h,6,58,64,2,1,0,1,NPC
BRD-A08027849_10uM_6h,BRD-A08027849,10 uM,6 h,6,55,61,2,0,0,0,NPC
BML-266_10uM_6h,BML-266,10 uM,6 h,6,55,61,2,5,1,4,NPC
TCPOBOP_10uM_6h,TCPOBOP,10 uM,6 h,6,55,61,2,1,1,0,NPC
BRD-K35923252_10uM_6h,BRD-K35923252,10 uM,6 h,6,55,61,2,71,41,30,NPC
BRD-A95074085_10uM_6h,BRD-A95074085,10 uM,6 h,6,55,61,2,0,0,0,NPC
IQ1_10uM_24h,IQ1,10 uM,24 h,6,58,64,2,248,71,177,NPC
triacetylresveratrol_10uM_6h,triacetylresveratrol,10 uM,6 h,6,55,61,2,0,0,0,NPC
brefeldin-a_10uM_6h,brefeldin-a,10 uM,6 h,6,55,61,2,69,37,32,NPC
BG-1011_10uM_24h,BG-1011,10 uM,24 h,6,58,64,2,80,16,64,NPC
GSK-429286A_0.04uM_24h,GSK-429286A,0.04 uM,24 h,6,130,136,3,24,14,10,NPC
BGT-226_0.12uM_24h,BGT-226,0.12 uM,24 h,6,131,137,2,508,206,302,NPC
LY-294002_0.37uM_24h,LY-294002,0.37 uM,24 h,6,99,105,2,2,1,1,NPC
BRD-K68336408_0.37uM_24h,BRD-K68336408,0.37 uM,24 h,6,132,138,3,32,26,6,NPC
BRD-A19037878_0.37uM_24h,BRD-A19037878,0.37 uM,24 h,6,99,105,2,323,164,159,NPC
HG-9-91-01_0.37uM_24h,HG-9-91-01,0.37 uM,24 h,6,131,137,3,44,18,26,NPC
bafilomycin_1.11uM_24h,bafilomycin,1.11 uM,24 h,6,58,64,2,187,59,128,NPC
BRD-A19037878_1.11uM_24h,BRD-A19037878,1.11 uM,24 h,6,99,105,2,507,261,246,NPC
LY-294002_1.11uM_24h,LY-294002,1.11 uM,24 h,6,99,105,2,0,0,0,NPC
bafilomycin_1.11uM_6h,bafilomycin,1.11 uM,6 h,6,55,61,2,14,7,7,NPC
BRD-A19037878_3.33uM_24h,BRD-A19037878,3.33 uM,24 h,6,99,105,2,544,276,268,NPC
ALW-II-49-7_3.33uM_24h,ALW-II-49-7,3.33 uM,24 h,6,131,137,3,20,8,12,NPC
LY-294002_3.33uM_24h,LY-294002,3.33 uM,24 h,6,99,105,2,7,2,5,NPC
A-66_3.33uM_24h,A-66,3.33 uM,24 h,6,131,137,3,109,58,51,NPC
WZ-7043_3.33uM_24h,WZ-7043,3.33 uM,24 h,6,131,137,3,286,112,174,NPC
methoxypyruvic-acid_10uM_24h,methoxypyruvic-acid,10 uM,24 h,5,66,71,2,0,0,0,NPC
BRD-K98336812_10uM_24h,BRD-K98336812,10 uM,24 h,5,66,71,2,0,0,0,NPC
BRD-U65466710_10uM_6h,BRD-U65466710,10 uM,6 h,5,54,59,2,1,1,0,NPC
BRD-A81472640_10uM_24h,BRD-A81472640,10 uM,24 h,5,66,71,2,1,0,1,NPC
KW-06_10uM_24h,KW-06,10 uM,24 h,5,66,71,2,9,7,2,NPC
BRD-K43631199_10uM_24h,BRD-K43631199,10 uM,24 h,5,66,71,2,46,17,29,NPC
BRD-K27237442_10uM_6h,BRD-K27237442,10 uM,6 h,5,54,59,2,0,0,0,NPC
BRD-A78236793_10uM_6h,BRD-A78236793,10 uM,6 h,5,54,59,2,193,65,128,NPC
BRD-K43014159_10uM_24h,BRD-K43014159,10 uM,24 h,5,66,71,2,1,1,0,NPC
BRD-K91844626_10uM_24h,BRD-K91844626,10 uM,24 h,5,66,71,2,0,0,0,NPC
BRD-U65466710_10uM_24h,BRD-U65466710,10 uM,24 h,5,66,71,2,1,1,0,NPC
BRD-K18573821_10uM_6h,BRD-K18573821,10 uM,6 h,5,54,59,2,14,2,12,NPC
BRD-K25701726_10uM_24h,BRD-K25701726,10 uM,24 h,5,66,71,2,0,0,0,NPC
BRD-K31460632_10uM_24h,BRD-K31460632,10 uM,24 h,5,66,71,2,0,0,0,NPC
WAY-405_10uM_6h,WAY-405,10 uM,6 h,5,54,59,2,2,1,1,NPC
BRD-K63116520_10uM_6h,BRD-K63116520,10 uM,6 h,5,54,59,2,1,0,1,NPC
BRD-K56622826_10uM_24h,BRD-K56622826,10 uM,24 h,5,66,71,2,0,0,0,NPC
BRD-K95847244_10uM_24h,BRD-K95847244,10 uM,24 h,5,66,71,2,2,1,1,NPC
BRD-K31344914_10uM_6h,BRD-K31344914,10 uM,6 h,5,54,59,2,0,0,0,NPC
BRD-A42187224_10uM_6h,BRD-A42187224,10 uM,6 h,5,54,59,2,1,0,1,NPC
BRD-K00878439_10uM_6h,BRD-K00878439,10 uM,6 h,5,54,59,2,0,0,0,NPC
BRD-A77098556_10uM_24h,BRD-A77098556,10 uM,24 h,5,66,71,2,4,4,0,NPC
vanillyl-glycol_10uM_6h,vanillyl-glycol,10 uM,6 h,5,54,59,2,1,0,1,NPC
BRD-K56622826_10uM_6h,BRD-K56622826,10 uM,6 h,5,54,59,2,27,4,23,NPC
BRD-K06209536_10uM_24h,BRD-K06209536,10 uM,24 h,5,66,71,2,3,2,1,NPC
BRD-A26347577_10uM_6h,BRD-A26347577,10 uM,6 h,5,54,59,2,0,0,0,NPC
BRD-A18795974_10uM_24h,BRD-A18795974,10 uM,24 h,5,66,71,2,0,0,0,NPC
BRD-A35072120_10uM_6h,BRD-A35072120,10 uM,6 h,5,54,59,2,5,1,4,NPC
BRD-K83068825_10uM_24h,BRD-K83068825,10 uM,24 h,5,66,71,2,0,0,0,NPC
BRD-K99554241_10uM_6h,BRD-K99554241,10 uM,6 h,5,54,59,2,2,0,2,NPC
BRD-A31180007_10uM_24h,BRD-A31180007,10 uM,24 h,5,66,71,2,4,3,1,NPC
BRD-K07653295_10uM_24h,BRD-K07653295,10 uM,24 h,5,66,71,2,41,34,7,NPC
WAY-405_10uM_24h,WAY-405,10 uM,24 h,5,66,71,2,2,1,1,NPC
BRD-M29370314_10uM_6h,BRD-M29370314,10 uM,6 h,5,54,59,2,1,1,0,NPC
BRD-K15241725_10uM_24h,BRD-K15241725,10 uM,24 h,5,66,71,2,0,0,0,NPC
BRD-K07223205_10uM_24h,BRD-K07223205,10 uM,24 h,5,66,71,2,5,2,3,NPC
lactotensin_10uM_6h,lactotensin,10 uM,6 h,5,54,59,2,0,0,0,NPC
dichlorobenzamil_10uM_6h,dichlorobenzamil,10 uM,6 h,5,54,59,2,15,13,2,NPC
BRD-K09887211_10uM_6h,BRD-K09887211,10 uM,6 h,5,54,59,2,0,0,0,NPC
propanoic-acid_10uM_6h,propanoic-acid,10 uM,6 h,5,54,59,2,0,0,0,NPC
BRD-A65771317_10uM_24h,BRD-A65771317,10 uM,24 h,5,66,71,2,0,0,0,NPC
SR-142948_10uM_6h,SR-142948,10 uM,6 h,5,54,59,2,29,1,28,NPC
BG-1001_10uM_24h,BG-1001,10 uM,24 h,5,66,71,2,51,16,35,NPC
BRD-A35072120_10uM_24h,BRD-A35072120,10 uM,24 h,5,66,71,2,1,0,1,NPC
BRD-K97591839_10uM_24h,BRD-K97591839,10 uM,24 h,5,66,71,2,0,0,0,NPC
BRD-A14999564_10uM_24h,BRD-A14999564,10 uM,24 h,5,66,71,2,0,0,0,NPC
APEC_10uM_6h,APEC,10 uM,6 h,5,54,59,2,1,0,1,NPC
BRD-A35825362_10uM_24h,BRD-A35825362,10 uM,24 h,5,66,71,2,1,1,0,NPC
tropapride_10uM_6h,tropapride,10 uM,6 h,5,54,59,2,0,0,0,NPC
methyltyramine_10uM_24h,methyltyramine,10 uM,24 h,5,66,71,2,1,0,1,NPC
BRD-A31180007_10uM_6h,BRD-A31180007,10 uM,6 h,5,54,59,2,34,17,17,NPC
BRD-A79058669_10uM_24h,BRD-A79058669,10 uM,24 h,5,66,71,2,0,0,0,NPC
Fluoro-SAHA_10uM_24h,Fluoro-SAHA,10 uM,24 h,5,66,71,2,342,168,174,NPC
BRD-K10283649_10uM_6h,BRD-K10283649,10 uM,6 h,5,54,59,2,0,0,0,NPC
Fluoro-SAHA_10uM_6h,Fluoro-SAHA,10 uM,6 h,5,54,59,2,249,82,167,NPC
BRD-A09073503_10uM_24h,BRD-A09073503,10 uM,24 h,5,66,71,2,0,0,0,NPC
BRD-K23986500_10uM_6h,BRD-K23986500,10 uM,6 h,5,54,59,2,5,4,1,NPC
BRD-A52530852_10uM_24h,BRD-A52530852,10 uM,24 h,5,66,71,2,1,1,0,NPC
BG-1003_10uM_24h,BG-1003,10 uM,24 h,5,66,71,2,431,197,234,NPC
BRD-K56621596_10uM_6h,BRD-K56621596,10 uM,6 h,5,54,59,2,1,1,0,NPC
BRD-A61866602_10uM_24h,BRD-A61866602,10 uM,24 h,5,66,71,2,0,0,0,NPC
BRD-K39981244_10uM_6h,BRD-K39981244,10 uM,6 h,5,54,59,2,2,0,2,NPC
BRD-A55317422_10uM_6h,BRD-A55317422,10 uM,6 h,5,54,59,2,4,2,2,NPC
BRD-K24307074_10uM_6h,BRD-K24307074,10 uM,6 h,5,54,59,2,0,0,0,NPC
SIB-1508Y_10uM_6h,SIB-1508Y,10 uM,6 h,5,54,59,2,30,7,23,NPC
BRD-K96043519_10uM_6h,BRD-K96043519,10 uM,6 h,5,54,59,2,6,1,5,NPC
BRD-K65213718_10uM_6h,BRD-K65213718,10 uM,6 h,5,54,59,2,8,6,2,NPC
BRD-A77864279_10uM_24h,BRD-A77864279,10 uM,24 h,5,66,71,2,2,2,0,NPC
vanillyl-glycol_10uM_24h,vanillyl-glycol,10 uM,24 h,5,66,71,2,0,0,0,NPC
BRD-K40367460_10uM_6h,BRD-K40367460,10 uM,6 h,5,54,59,2,0,0,0,NPC
dinorcitalopram-oxalate_10uM_24h,dinorcitalopram-oxalate,10 uM,24 h,5,66,71,2,0,0,0,NPC
BRD-K31168993_10uM_6h,BRD-K31168993,10 uM,6 h,5,54,59,2,1,1,0,NPC
alendronic-acid_10uM_24h,alendronic-acid,10 uM,24 h,5,66,71,2,2,1,1,NPC
BRD-A48349196_10uM_24h,BRD-A48349196,10 uM,24 h,5,66,71,2,0,0,0,NPC
BRD-M91737268_10uM_6h,BRD-M91737268,10 uM,6 h,5,54,59,2,0,0,0,NPC
velnacrine_10uM_6h,velnacrine,10 uM,6 h,5,54,59,2,0,0,0,NPC
BRD-M25555076_10uM_24h,BRD-M25555076,10 uM,24 h,5,66,71,2,1,0,1,NPC
BRD-K97591839_10uM_6h,BRD-K97591839,10 uM,6 h,5,54,59,2,0,0,0,NPC
BRD-K18436203_10uM_6h,BRD-K18436203,10 uM,6 h,5,54,59,2,22,1,21,NPC
BRD-K88575585_10uM_24h,BRD-K88575585,10 uM,24 h,5,66,71,2,0,0,0,NPC
BRD-A06779035_10uM_6h,BRD-A06779035,10 uM,6 h,5,54,59,2,3,0,3,NPC
hydroxytyrosol_10uM_6h,hydroxytyrosol,10 uM,6 h,5,54,59,2,0,0,0,NPC
SK-383933_10uM_24h,SK-383933,10 uM,24 h,5,66,71,2,240,123,117,NPC
BG-1004_10uM_24h,BG-1004,10 uM,24 h,5,66,71,2,304,138,166,NPC
BRD-M28563253_10uM_24h,BRD-M28563253,10 uM,24 h,5,66,71,2,0,0,0,NPC
BRD-K59915259_10uM_6h,BRD-K59915259,10 uM,6 h,5,54,59,2,34,9,25,NPC
BRD-K31344914_10uM_24h,BRD-K31344914,10 uM,24 h,5,66,71,2,2,2,0,NPC
BRD-K43807558_10uM_24h,BRD-K43807558,10 uM,24 h,5,66,71,2,0,0,0,NPC
BRD-A84423900_10uM_6h,BRD-A84423900,10 uM,6 h,5,54,59,2,88,42,46,NPC
n-methylphenothiazine_10uM_6h,n-methylphenothiazine,10 uM,6 h,5,54,59,2,0,0,0,NPC
BRD-K92326486_10uM_6h,BRD-K92326486,10 uM,6 h,5,54,59,2,1,1,0,NPC
BRD-K79052598_10uM_6h,BRD-K79052598,10 uM,6 h,5,54,59,2,0,0,0,NPC
GGTI-297_10uM_24h,GGTI-297,10 uM,24 h,5,66,71,2,2,1,1,NPC
BRD-K39172790_10uM_24h,BRD-K39172790,10 uM,24 h,5,66,71,2,35,19,16,NPC
BRD-K47535255_10uM_6h,BRD-K47535255,10 uM,6 h,5,54,59,2,36,31,5,NPC
6-nitrodopamine_10uM_24h,6-nitrodopamine,10 uM,24 h,5,66,71,2,0,0,0,NPC
BRD-A00763758_10uM_6h,BRD-A00763758,10 uM,6 h,5,54,59,2,0,0,0,NPC
BRD-A09073503_10uM_6h,BRD-A09073503,10 uM,6 h,5,54,59,2,15,1,14,NPC
BRD-K07653295_10uM_6h,BRD-K07653295,10 uM,6 h,5,54,59,2,0,0,0,NPC
methoxypyruvic-acid_10uM_6h,methoxypyruvic-acid,10 uM,6 h,5,54,59,2,0,0,0,NPC
PD-149163_10uM_6h,PD-149163,10 uM,6 h,5,54,59,2,0,0,0,NPC
BRD-K36269259_10uM_24h,BRD-K36269259,10 uM,24 h,5,66,71,2,2,2,0,NPC
salvinorin-a_10uM_24h,salvinorin-a,10 uM,24 h,5,72,77,2,2,1,1,NPC
BRD-U85918428_10uM_6h,BRD-U85918428,10 uM,6 h,5,54,59,2,4,1,3,NPC
BRD-A75769921_10uM_24h,BRD-A75769921,10 uM,24 h,5,66,71,2,1,1,0,NPC
BRD-K69458799_10uM_6h,BRD-K69458799,10 uM,6 h,5,54,59,2,0,0,0,NPC
BRD-A86146706_10uM_6h,BRD-A86146706,10 uM,6 h,5,54,59,2,99,33,66,NPC
W-5_10uM_24h,W-5,10 uM,24 h,5,66,71,2,0,0,0,NPC
salsoline_10uM_24h,salsoline,10 uM,24 h,5,66,71,2,0,0,0,NPC
BRD-K75971499_10uM_24h,BRD-K75971499,10 uM,24 h,5,66,71,2,204,87,117,NPC
aminoresveratrol_10uM_6h,aminoresveratrol,10 uM,6 h,5,44,49,2,116,61,55,NPC
BRD-K13629382_10uM_6h,BRD-K13629382,10 uM,6 h,5,54,59,2,222,122,100,NPC
aminobenztropine_10uM_6h,aminobenztropine,10 uM,6 h,5,54,59,2,5,4,1,NPC
BRD-K33445737_10uM_6h,BRD-K33445737,10 uM,6 h,5,54,59,2,110,58,52,NPC
KDM-103_10uM_24h,KDM-103,10 uM,24 h,5,66,71,2,43,27,16,NPC
BRD-K41824522_10uM_24h,BRD-K41824522,10 uM,24 h,5,66,71,2,0,0,0,NPC
BRD-A69454249_10uM_6h,BRD-A69454249,10 uM,6 h,5,54,59,2,0,0,0,NPC
BRD-K19653414_10uM_24h,BRD-K19653414,10 uM,24 h,5,66,71,2,0,0,0,NPC
BRD-K78787248_10uM_6h,BRD-K78787248,10 uM,6 h,5,54,59,2,0,0,0,NPC
BRD-K10939925_10uM_24h,BRD-K10939925,10 uM,24 h,5,66,71,2,0,0,0,NPC
LY-165163_10uM_6h,LY-165163,10 uM,6 h,5,54,59,2,1,1,0,NPC
SKF-82958_10uM_6h,SKF-82958,10 uM,6 h,5,54,59,2,2,2,0,NPC
BRD-M16214895_10uM_6h,BRD-M16214895,10 uM,6 h,5,54,59,2,0,0,0,NPC
BRD-A27924917_10uM_24h,BRD-A27924917,10 uM,24 h,5,66,71,2,0,0,0,NPC
BRD-A41986761_10uM_6h,BRD-A41986761,10 uM,6 h,5,54,59,2,0,0,0,NPC
BRD-K33943862_10uM_24h,BRD-K33943862,10 uM,24 h,5,66,71,2,0,0,0,NPC
n-bromoacetyltryptamine_10uM_6h,n-bromoacetyltryptamine,10 uM,6 h,5,54,59,2,120,69,51,NPC
BRD-K74773935_10uM_6h,BRD-K74773935,10 uM,6 h,5,54,59,2,2,1,1,NPC
BRD-K38720323_10uM_24h,BRD-K38720323,10 uM,24 h,5,66,71,2,0,0,0,NPC
alendronic-acid_10uM_6h,alendronic-acid,10 uM,6 h,5,54,59,2,0,0,0,NPC
BRD-M15189060_10uM_24h,BRD-M15189060,10 uM,24 h,5,66,71,2,0,0,0,NPC
BRD-A29342309_10uM_24h,BRD-A29342309,10 uM,24 h,5,66,71,2,0,0,0,NPC
BRD-A92334183_10uM_6h,BRD-A92334183,10 uM,6 h,5,54,59,2,0,0,0,NPC
beta-alanine_10uM_24h,beta-alanine,10 uM,24 h,5,66,71,2,0,0,0,NPC
SR-48692_10uM_6h,SR-48692,10 uM,6 h,5,54,59,2,1,0,1,NPC
BRD-A75769921_10uM_6h,BRD-A75769921,10 uM,6 h,5,54,59,2,0,0,0,NPC
BRD-K23628492_10uM_6h,BRD-K23628492,10 uM,6 h,5,54,59,2,0,0,0,NPC
BG-1001_10uM_6h,BG-1001,10 uM,6 h,5,54,59,2,93,23,70,NPC
SKF-83959_10uM_24h,SKF-83959,10 uM,24 h,5,66,71,2,5,4,1,NPC
BRD-A11009626_10uM_6h,BRD-A11009626,10 uM,6 h,5,54,59,2,145,51,94,NPC
BRD-A69454249_10uM_24h,BRD-A69454249,10 uM,24 h,5,66,71,2,1,0,1,NPC
trans-bis-q_10uM_24h,trans-bis-q,10 uM,24 h,5,66,71,2,0,0,0,NPC
BRD-K19042873_10uM_6h,BRD-K19042873,10 uM,6 h,5,54,59,2,28,23,5,NPC
BRD-A35825362_10uM_6h,BRD-A35825362,10 uM,6 h,5,54,59,2,1,1,0,NPC
epidepride_10uM_6h,epidepride,10 uM,6 h,5,54,59,2,0,0,0,NPC
BRD-K76108747_10uM_24h,BRD-K76108747,10 uM,24 h,5,66,71,2,2,1,1,NPC
BRD-K27803479_10uM_24h,BRD-K27803479,10 uM,24 h,5,66,71,2,0,0,0,NPC
6-nitronorepinephrine_10uM_6h,6-nitronorepinephrine,10 uM,6 h,5,54,59,2,0,0,0,NPC
BRD-K91614993_10uM_6h,BRD-K91614993,10 uM,6 h,5,54,59,2,7,1,6,NPC
IDAM_10uM_24h,IDAM,10 uM,24 h,5,66,71,2,1,1,0,NPC
BRD-K54472228_10uM_6h,BRD-K54472228,10 uM,6 h,5,54,59,2,0,0,0,NPC
BRD-A74767450_10uM_6h,BRD-A74767450,10 uM,6 h,5,54,59,2,0,0,0,NPC
BRD-K82326223_10uM_6h,BRD-K82326223,10 uM,6 h,5,54,59,2,0,0,0,NPC
BRD-K58930050_10uM_24h,BRD-K58930050,10 uM,24 h,5,66,71,2,41,26,15,NPC
BRD-K19653414_10uM_6h,BRD-K19653414,10 uM,6 h,5,54,59,2,0,0,0,NPC
BRD-K91614993_10uM_24h,BRD-K91614993,10 uM,24 h,5,66,71,2,18,12,6,NPC
BRD-K07223205_10uM_6h,BRD-K07223205,10 uM,6 h,5,54,59,2,6,4,2,NPC
norcitalopram_10uM_6h,norcitalopram,10 uM,6 h,5,54,59,2,38,6,32,NPC
BRD-K75971499_10uM_6h,BRD-K75971499,10 uM,6 h,5,54,59,2,34,18,16,NPC
isosalsoline_10uM_24h,isosalsoline,10 uM,24 h,5,66,71,2,1,0,1,NPC
BRD-K95767742_10uM_24h,BRD-K95767742,10 uM,24 h,5,66,71,2,0,0,0,NPC
BRD-A26333730_10uM_24h,BRD-A26333730,10 uM,24 h,5,66,71,2,0,0,0,NPC
GGTI-297_10uM_6h,GGTI-297,10 uM,6 h,5,54,59,2,0,0,0,NPC
SKF-83822_10uM_6h,SKF-83822,10 uM,6 h,5,54,59,2,27,2,25,NPC
BRD-A40163033_10uM_24h,BRD-A40163033,10 uM,24 h,5,66,71,2,0,0,0,NPC
BRD-K15241725_10uM_6h,BRD-K15241725,10 uM,6 h,5,54,59,2,2,2,0,NPC
BRD-A00763758_10uM_24h,BRD-A00763758,10 uM,24 h,5,66,71,2,2,1,1,NPC
BRD-K58930050_10uM_6h,BRD-K58930050,10 uM,6 h,5,54,59,2,44,5,39,NPC
BRD-K94158209_10uM_6h,BRD-K94158209,10 uM,6 h,5,54,59,2,15,2,13,NPC
BRD-K13195996_10uM_24h,BRD-K13195996,10 uM,24 h,5,66,71,2,1,0,1,NPC
L-744832_10uM_6h,L-744832,10 uM,6 h,5,54,59,2,3,3,0,NPC
BRD-A00150179_10uM_6h,BRD-A00150179,10 uM,6 h,5,54,59,2,0,0,0,NPC
BRD-M68558198_10uM_24h,BRD-M68558198,10 uM,24 h,5,66,71,2,0,0,0,NPC
BRD-K03608458_10uM_6h,BRD-K03608458,10 uM,6 h,5,54,59,2,0,0,0,NPC
BRD-A48349196_10uM_6h,BRD-A48349196,10 uM,6 h,5,54,59,2,0,0,0,NPC
BRD-A14795281_10uM_6h,BRD-A14795281,10 uM,6 h,5,54,59,2,0,0,0,NPC
BRD-K83836748_10uM_6h,BRD-K83836748,10 uM,6 h,5,54,59,2,8,5,3,NPC
BRD-K31460632_10uM_6h,BRD-K31460632,10 uM,6 h,5,54,59,2,0,0,0,NPC
kavain_10uM_6h,kavain,10 uM,6 h,5,54,59,2,1,0,1,NPC
p-aminophenethylspiperone_10uM_6h,p-aminophenethylspiperone,10 uM,6 h,5,54,59,2,46,34,12,NPC
BRD-K36269259_10uM_6h,BRD-K36269259,10 uM,6 h,5,54,59,2,5,3,2,NPC
HDAC3-selective_10uM_24h,HDAC3-selective,10 uM,24 h,5,66,71,2,37,11,26,NPC
BG-1004_10uM_6h,BG-1004,10 uM,6 h,5,54,59,2,196,74,122,NPC
BRD-K84252391_10uM_24h,BRD-K84252391,10 uM,24 h,5,66,71,2,1,0,1,NPC
BRD-U57440914_10uM_24h,BRD-U57440914,10 uM,24 h,5,66,71,2,5,4,1,NPC
BRD-K67582595_10uM_24h,BRD-K67582595,10 uM,24 h,5,66,71,2,34,20,14,NPC
BRD-K53249762_10uM_24h,BRD-K53249762,10 uM,24 h,5,66,71,2,2,1,1,NPC
BRD-K98336812_10uM_6h,BRD-K98336812,10 uM,6 h,5,54,59,2,1,1,0,NPC
BRD-A74767450_10uM_24h,BRD-A74767450,10 uM,24 h,5,66,71,2,1,1,0,NPC
JMV-431_10uM_24h,JMV-431,10 uM,24 h,5,66,71,2,0,0,0,NPC
BRD-K28308851_10uM_24h,BRD-K28308851,10 uM,24 h,5,66,71,2,0,0,0,NPC
BRD-K83161876_10uM_6h,BRD-K83161876,10 uM,6 h,5,54,59,2,0,0,0,NPC
BRD-A84423900_10uM_24h,BRD-A84423900,10 uM,24 h,5,66,71,2,0,0,0,NPC
BRD-K95767742_10uM_6h,BRD-K95767742,10 uM,6 h,5,54,59,2,1,1,0,NPC
DASB_10uM_6h,DASB,10 uM,6 h,5,54,59,2,1,0,1,NPC
BRD-K72015216_10uM_24h,BRD-K72015216,10 uM,24 h,5,66,71,2,0,0,0,NPC
BRD-M25555076_10uM_6h,BRD-M25555076,10 uM,6 h,5,54,59,2,1,0,1,NPC
BRD-K91781484_10uM_6h,BRD-K91781484,10 uM,6 h,5,54,59,2,0,0,0,NPC
BRD-A09053961_10uM_6h,BRD-A09053961,10 uM,6 h,5,54,59,2,1,1,0,NPC
BRD-K71339761_10uM_24h,BRD-K71339761,10 uM,24 h,5,66,71,2,68,19,49,NPC
BRD-A76934284_10uM_6h,BRD-A76934284,10 uM,6 h,5,54,59,2,2,1,1,NPC
BRD-A94494639_10uM_24h,BRD-A94494639,10 uM,24 h,5,66,71,2,4,3,1,NPC
SK-383933_10uM_6h,SK-383933,10 uM,6 h,5,54,59,2,0,0,0,NPC
BRD-A42610307_10uM_6h,BRD-A42610307,10 uM,6 h,5,54,59,2,71,23,48,NPC
BRD-K56994829_10uM_6h,BRD-K56994829,10 uM,6 h,5,54,59,2,18,6,12,NPC
BRD-A12426960_10uM_24h,BRD-A12426960,10 uM,24 h,5,66,71,2,0,0,0,NPC
BRD-A35153197_10uM_6h,BRD-A35153197,10 uM,6 h,5,54,59,2,0,0,0,NPC
BRD-K67582595_10uM_6h,BRD-K67582595,10 uM,6 h,5,54,59,2,1,0,1,NPC
tyramine_10uM_6h,tyramine,10 uM,6 h,5,54,59,2,0,0,0,NPC
BRD-K43807558_10uM_6h,BRD-K43807558,10 uM,6 h,5,54,59,2,20,3,17,NPC
KDM-103_10uM_6h,KDM-103,10 uM,6 h,5,54,59,2,2,0,2,NPC
allantoxanamide_10uM_6h,allantoxanamide,10 uM,6 h,5,54,59,2,0,0,0,NPC
6-nitrodopamine_10uM_6h,6-nitrodopamine,10 uM,6 h,5,54,59,2,0,0,0,NPC
BRD-K49612115_10uM_6h,BRD-K49612115,10 uM,6 h,5,54,59,2,14,2,12,NPC
L-744832_10uM_24h,L-744832,10 uM,24 h,5,66,71,2,0,0,0,NPC
BRD-K20985754_10uM_24h,BRD-K20985754,10 uM,24 h,5,66,71,2,0,0,0,NPC
BRD-A65140285_10uM_6h,BRD-A65140285,10 uM,6 h,5,54,59,2,0,0,0,NPC
BRD-K04722205_10uM_6h,BRD-K04722205,10 uM,6 h,5,47,52,2,0,0,0,NPC
HDAC3-selective_10uM_6h,HDAC3-selective,10 uM,6 h,5,54,59,2,187,37,150,NPC
BRD-K96834847_10uM_6h,BRD-K96834847,10 uM,6 h,5,54,59,2,0,0,0,NPC
BRD-K15181602_10uM_6h,BRD-K15181602,10 uM,6 h,5,54,59,2,0,0,0,NPC
BG-1002_10uM_24h,BG-1002,10 uM,24 h,5,66,71,2,3,2,1,NPC
lactotensin_10uM_24h,lactotensin,10 uM,24 h,5,66,71,2,2,2,0,NPC
SR-12813_10uM_24h,SR-12813,10 uM,24 h,5,66,71,2,0,0,0,NPC
salsoline_10uM_6h,salsoline,10 uM,6 h,5,54,59,2,7,2,5,NPC
2-aminotetralin_10uM_6h,2-aminotetralin,10 uM,6 h,5,54,59,2,0,0,0,NPC
BRD-K37365015_10uM_6h,BRD-K37365015,10 uM,6 h,5,54,59,2,26,13,13,NPC
SKF-104078_10uM_24h,SKF-104078,10 uM,24 h,5,66,71,2,14,5,9,NPC
BRD-U85918428_10uM_24h,BRD-U85918428,10 uM,24 h,5,66,71,2,3,1,2,NPC
BRD-M15189060_10uM_6h,BRD-M15189060,10 uM,6 h,5,54,59,2,0,0,0,NPC
JMV-431_10uM_6h,JMV-431,10 uM,6 h,5,54,59,2,0,0,0,NPC
BRD-K86940927_10uM_6h,BRD-K86940927,10 uM,6 h,5,54,59,2,14,3,11,NPC
BRD-K96043519_10uM_24h,BRD-K96043519,10 uM,24 h,5,66,71,2,1,0,1,NPC
BRD-A00150179_10uM_24h,BRD-A00150179,10 uM,24 h,5,66,71,2,2,2,0,NPC
BRD-K24307074_10uM_24h,BRD-K24307074,10 uM,24 h,5,66,71,2,0,0,0,NPC
BRD-K49612115_10uM_24h,BRD-K49612115,10 uM,24 h,5,66,71,2,36,21,15,NPC
BRD-K13629382_10uM_24h,BRD-K13629382,10 uM,24 h,5,66,71,2,191,95,96,NPC
BRD-K24304282_10uM_6h,BRD-K24304282,10 uM,6 h,5,54,59,2,0,0,0,NPC
BRD-K40167599_10uM_6h,BRD-K40167599,10 uM,6 h,5,54,59,2,2,2,0,NPC
BRD-A52530852_10uM_6h,BRD-A52530852,10 uM,6 h,5,54,59,2,0,0,0,NPC
BRD-K84252391_10uM_6h,BRD-K84252391,10 uM,6 h,5,54,59,2,0,0,0,NPC
BRD-U71399930_10uM_6h,BRD-U71399930,10 uM,6 h,5,54,59,2,0,0,0,NPC
GGTI-2133_10uM_6h,GGTI-2133,10 uM,6 h,5,54,59,2,0,0,0,NPC
DASB_10uM_24h,DASB,10 uM,24 h,5,66,71,2,1,1,0,NPC
BRD-A04332542_10uM_24h,BRD-A04332542,10 uM,24 h,5,66,71,2,0,0,0,NPC
BRD-K43631199_10uM_6h,BRD-K43631199,10 uM,6 h,5,54,59,2,34,11,23,NPC
BRD-K15181602_10uM_24h,BRD-K15181602,10 uM,24 h,5,66,71,2,0,0,0,NPC
chrysamine-g_10uM_6h,chrysamine-g,10 uM,6 h,5,54,59,2,6,0,6,NPC
BRD-K43014159_10uM_6h,BRD-K43014159,10 uM,6 h,5,54,59,2,0,0,0,NPC
BRD-A52647795_10uM_24h,BRD-A52647795,10 uM,24 h,5,66,71,2,0,0,0,NPC
bietaserpine_10uM_6h,bietaserpine,10 uM,6 h,5,54,59,2,3,3,0,NPC
HO-013_10uM_6h,HO-013,10 uM,6 h,5,47,52,2,26,4,22,NPC
BRD-A82323890_10uM_6h,BRD-A82323890,10 uM,6 h,5,54,59,2,0,0,0,NPC
BRD-A24951056_10uM_6h,BRD-A24951056,10 uM,6 h,5,54,59,2,0,0,0,NPC
BRD-K59915259_10uM_24h,BRD-K59915259,10 uM,24 h,5,66,71,2,7,6,1,NPC
BRD-A51916548_10uM_6h,BRD-A51916548,10 uM,6 h,5,54,59,2,1,0,1,NPC
EHPG-piperazine_10uM_6h,EHPG-piperazine,10 uM,6 h,5,54,59,2,0,0,0,NPC
BRD-K41049123_10uM_6h,BRD-K41049123,10 uM,6 h,5,54,59,2,24,15,9,NPC
BRD-M68558198_10uM_6h,BRD-M68558198,10 uM,6 h,5,54,59,2,0,0,0,NPC
BRD-K76108747_10uM_6h,BRD-K76108747,10 uM,6 h,5,54,59,2,0,0,0,NPC
BRD-K56621596_10uM_24h,BRD-K56621596,10 uM,24 h,5,66,71,2,0,0,0,NPC
BRD-A65771317_10uM_6h,BRD-A65771317,10 uM,6 h,5,54,59,2,0,0,0,NPC
BRD-K54472228_10uM_24h,BRD-K54472228,10 uM,24 h,5,66,71,2,49,26,23,NPC
BRD-A52647795_10uM_6h,BRD-A52647795,10 uM,6 h,5,54,59,2,0,0,0,NPC
6-nitronorepinephrine_10uM_24h,6-nitronorepinephrine,10 uM,24 h,5,66,71,2,1,1,0,NPC
BRD-A29119732_10uM_24h,BRD-A29119732,10 uM,24 h,5,66,71,2,8,7,1,NPC
BRD-K94158209_10uM_24h,BRD-K94158209,10 uM,24 h,5,66,71,2,1,0,1,NPC
BRD-A29119732_10uM_6h,BRD-A29119732,10 uM,6 h,5,54,59,2,7,2,5,NPC
BRD-K28308851_10uM_6h,BRD-K28308851,10 uM,6 h,5,54,59,2,1,1,0,NPC
BRD-A17081056_10uM_24h,BRD-A17081056,10 uM,24 h,5,66,71,2,31,24,7,NPC
BRD-A26347577_10uM_24h,BRD-A26347577,10 uM,24 h,5,66,71,2,0,0,0,NPC
BRD-K20985754_10uM_6h,BRD-K20985754,10 uM,6 h,5,54,59,2,0,0,0,NPC
BRD-K83068825_10uM_6h,BRD-K83068825,10 uM,6 h,5,54,59,2,1,1,0,NPC
BRD-K83161876_10uM_24h,BRD-K83161876,10 uM,24 h,5,66,71,2,0,0,0,NPC
BRD-K06209536_10uM_6h,BRD-K06209536,10 uM,6 h,5,54,59,2,22,16,6,NPC
BRD-K20151898_10uM_24h,BRD-K20151898,10 uM,24 h,5,66,71,2,0,0,0,NPC
n-methylphenothiazine_10uM_24h,n-methylphenothiazine,10 uM,24 h,5,66,71,2,3,0,3,NPC
BRD-A65140285_10uM_24h,BRD-A65140285,10 uM,24 h,5,66,71,2,0,0,0,NPC
BRD-K40367460_10uM_24h,BRD-K40367460,10 uM,24 h,5,66,71,2,0,0,0,NPC
dinorcitalopram-oxalate_10uM_6h,dinorcitalopram-oxalate,10 uM,6 h,5,54,59,2,12,7,5,NPC
glutamyldopamine_10uM_24h,glutamyldopamine,10 uM,24 h,5,66,71,2,1,0,1,NPC
SKF-83822_10uM_24h,SKF-83822,10 uM,24 h,5,66,71,2,107,57,50,NPC
BRD-K27803479_10uM_6h,BRD-K27803479,10 uM,6 h,5,54,59,2,48,34,14,NPC
BRD-A32582647_10uM_24h,BRD-A32582647,10 uM,24 h,5,66,71,2,0,0,0,NPC
A-23187_10uM_6h,A-23187,10 uM,6 h,5,47,52,2,174,58,116,NPC
PD-149163_10uM_24h,PD-149163,10 uM,24 h,5,66,71,2,0,0,0,NPC
BRD-A68802837_10uM_6h,BRD-A68802837,10 uM,6 h,5,54,59,2,0,0,0,NPC
SKF-83959_10uM_6h,SKF-83959,10 uM,6 h,5,54,59,2,4,1,3,NPC
BRD-K65981456_10uM_6h,BRD-K65981456,10 uM,6 h,5,54,59,2,0,0,0,NPC
BRD-K93859331_10uM_24h,BRD-K93859331,10 uM,24 h,5,66,71,2,1,1,0,NPC
BRD-K00878439_10uM_24h,BRD-K00878439,10 uM,24 h,5,66,71,2,1,0,1,NPC
tropapride_10uM_24h,tropapride,10 uM,24 h,5,66,71,2,0,0,0,NPC
bietaserpine_10uM_24h,bietaserpine,10 uM,24 h,5,66,71,2,1,0,1,NPC
1-methylisoquinoline_10uM_6h,1-methylisoquinoline,10 uM,6 h,5,54,59,2,0,0,0,NPC
BRD-A81472640_10uM_6h,BRD-A81472640,10 uM,6 h,5,54,59,2,0,0,0,NPC
BRD-K86940927_10uM_24h,BRD-K86940927,10 uM,24 h,5,66,71,2,0,0,0,NPC
BRD-K36651625_10uM_24h,BRD-K36651625,10 uM,24 h,5,66,71,2,0,0,0,NPC
SR-144528_10uM_24h,SR-144528,10 uM,24 h,5,66,71,2,0,0,0,NPC
BRD-K78787248_10uM_24h,BRD-K78787248,10 uM,24 h,5,66,71,2,1,0,1,NPC
mevalonic-acid_10uM_24h,mevalonic-acid,10 uM,24 h,5,66,71,2,0,0,0,NPC
BRD-K63350243_10uM_24h,BRD-K63350243,10 uM,24 h,5,46,51,2,136,51,85,NPC
BRD-K79052598_10uM_24h,BRD-K79052598,10 uM,24 h,5,66,71,2,1,1,0,NPC
BRD-A41986761_10uM_24h,BRD-A41986761,10 uM,24 h,5,66,71,2,2,1,1,NPC
BRD-K27237442_10uM_24h,BRD-K27237442,10 uM,24 h,5,66,71,2,0,0,0,NPC
BRD-K87166736_10uM_6h,BRD-K87166736,10 uM,6 h,5,54,59,2,0,0,0,NPC
BRD-K23628492_10uM_24h,BRD-K23628492,10 uM,24 h,5,66,71,2,0,0,0,NPC
BRD-K80062189_10uM_6h,BRD-K80062189,10 uM,6 h,5,54,59,2,78,22,56,NPC
BRD-K40167599_10uM_24h,BRD-K40167599,10 uM,24 h,5,66,71,2,0,0,0,NPC
SKF-82958_10uM_24h,SKF-82958,10 uM,24 h,5,66,71,2,0,0,0,NPC
BG-1002_10uM_6h,BG-1002,10 uM,6 h,5,54,59,2,30,1,29,NPC
BRD-K33943862_10uM_6h,BRD-K33943862,10 uM,6 h,5,54,59,2,2,1,1,NPC
BRD-K93859331_10uM_6h,BRD-K93859331,10 uM,6 h,5,54,59,2,1,1,0,NPC
BRD-A76934284_10uM_24h,BRD-A76934284,10 uM,24 h,5,66,71,2,0,0,0,NPC
BRD-A29342309_10uM_6h,BRD-A29342309,10 uM,6 h,5,54,59,2,0,0,0,NPC
BRD-K24304282_10uM_24h,BRD-K24304282,10 uM,24 h,5,66,71,2,0,0,0,NPC
BRD-K10283649_10uM_24h,BRD-K10283649,10 uM,24 h,5,66,71,2,11,6,5,NPC
BRD-K82326223_10uM_24h,BRD-K82326223,10 uM,24 h,5,66,71,2,7,4,3,NPC
latrunculin-b_10uM_24h,latrunculin-b,10 uM,24 h,5,29,34,1,0,0,0,NPC
p-aminophenethylspiperone_10uM_24h,p-aminophenethylspiperone,10 uM,24 h,5,66,71,2,141,69,72,NPC
KDM-096_10uM_24h,KDM-096,10 uM,24 h,5,66,71,2,14,11,3,NPC
BRD-K76941385_10uM_24h,BRD-K76941385,10 uM,24 h,5,66,71,2,0,0,0,NPC
BRD-A51916548_10uM_24h,BRD-A51916548,10 uM,24 h,5,66,71,2,0,0,0,NPC
BRD-A35153197_10uM_24h,BRD-A35153197,10 uM,24 h,5,66,71,2,1,0,1,NPC
SR-48692_10uM_24h,SR-48692,10 uM,24 h,5,66,71,2,129,47,82,NPC
BRD-A04332542_10uM_6h,BRD-A04332542,10 uM,6 h,5,54,59,2,1,0,1,NPC
BRD-K70980943_10uM_24h,BRD-K70980943,10 uM,24 h,5,66,71,2,1,1,0,NPC
BRD-A92334183_10uM_24h,BRD-A92334183,10 uM,24 h,5,66,71,2,0,0,0,NPC
methyltyramine_10uM_6h,methyltyramine,10 uM,6 h,5,54,59,2,0,0,0,NPC
trans-bis-q_10uM_6h,trans-bis-q,10 uM,6 h,5,54,59,2,1,0,1,NPC
EHPG-piperazine_10uM_24h,EHPG-piperazine,10 uM,24 h,5,66,71,2,0,0,0,NPC
BG-1003_10uM_6h,BG-1003,10 uM,6 h,5,54,59,2,220,94,126,NPC
BRD-A68802837_10uM_24h,BRD-A68802837,10 uM,24 h,5,66,71,2,0,0,0,NPC
W-5_10uM_6h,W-5,10 uM,6 h,5,54,59,2,0,0,0,NPC
BRD-A06779035_10uM_24h,BRD-A06779035,10 uM,24 h,5,66,71,2,0,0,0,NPC
BRD-K31168993_10uM_24h,BRD-K31168993,10 uM,24 h,5,66,71,2,0,0,0,NPC
BRD-A70541707_10uM_6h,BRD-A70541707,10 uM,6 h,5,54,59,2,38,29,9,NPC
BRD-K45845523_10uM_24h,BRD-K45845523,10 uM,24 h,5,66,71,2,1,1,0,NPC
BRD-K25701726_10uM_6h,BRD-K25701726,10 uM,6 h,5,54,59,2,9,1,8,NPC
norcitalopram_10uM_24h,norcitalopram,10 uM,24 h,5,66,71,2,12,4,8,NPC
KDM-096_10uM_6h,KDM-096,10 uM,6 h,5,54,59,2,1,0,1,NPC
hydroxytyrosol_10uM_24h,hydroxytyrosol,10 uM,24 h,5,66,71,2,1,0,1,NPC
BRD-K88575585_10uM_6h,BRD-K88575585,10 uM,6 h,5,54,59,2,29,17,12,NPC
glutamyldopamine_10uM_6h,glutamyldopamine,10 uM,6 h,5,54,59,2,0,0,0,NPC
SR-12813_10uM_6h,SR-12813,10 uM,6 h,5,54,59,2,62,13,49,NPC
BRD-K95847244_10uM_6h,BRD-K95847244,10 uM,6 h,5,54,59,2,2,2,0,NPC
BRD-K74773935_10uM_24h,BRD-K74773935,10 uM,24 h,5,66,71,2,1,1,0,NPC
KW-06_10uM_6h,KW-06,10 uM,6 h,5,54,59,2,9,1,8,NPC
BRD-K56994829_10uM_24h,BRD-K56994829,10 uM,24 h,5,66,71,2,0,0,0,NPC
BRD-A55317422_10uM_24h,BRD-A55317422,10 uM,24 h,5,66,71,2,0,0,0,NPC
F-1061-0166_10uM_24h,F-1061-0166,10 uM,24 h,5,46,51,2,444,172,272,NPC
SIB-1508Y_10uM_24h,SIB-1508Y,10 uM,24 h,5,66,71,2,1,1,0,NPC
BRD-K63116520_10uM_24h,BRD-K63116520,10 uM,24 h,5,66,71,2,0,0,0,NPC
BRD-K52453128_10uM_24h,BRD-K52453128,10 uM,24 h,5,66,71,2,2,2,0,NPC
LBH-589_10uM_6h,LBH-589,10 uM,6 h,5,54,59,2,262,95,167,NPC
BRD-A94494639_10uM_6h,BRD-A94494639,10 uM,6 h,5,54,59,2,1,0,1,NPC
allantoxanamide_10uM_24h,allantoxanamide,10 uM,24 h,5,66,71,2,3,2,1,NPC
BRD-A39986918_10uM_6h,BRD-A39986918,10 uM,6 h,5,54,59,2,0,0,0,NPC
BRD-A79058669_10uM_6h,BRD-A79058669,10 uM,6 h,5,54,59,2,0,0,0,NPC
SR-144528_10uM_6h,SR-144528,10 uM,6 h,5,54,59,2,1,0,1,NPC
BRD-A14795281_10uM_24h,BRD-A14795281,10 uM,24 h,5,66,71,2,0,0,0,NPC
BRD-K92159000_10uM_24h,BRD-K92159000,10 uM,24 h,5,66,71,2,8,2,6,NPC
BRD-K13195996_10uM_6h,BRD-K13195996,10 uM,6 h,5,54,59,2,2,2,0,NPC
chrysamine-g_10uM_24h,chrysamine-g,10 uM,24 h,5,66,71,2,0,0,0,NPC
BRD-K18573821_10uM_24h,BRD-K18573821,10 uM,24 h,5,66,71,2,0,0,0,NPC
BRD-K61260019_10uM_6h,BRD-K61260019,10 uM,6 h,5,54,59,2,0,0,0,NPC
BRD-M91737268_10uM_24h,BRD-M91737268,10 uM,24 h,5,66,71,2,0,0,0,NPC
IDAM_10uM_6h,IDAM,10 uM,6 h,5,54,59,2,0,0,0,NPC
propanoic-acid_10uM_24h,propanoic-acid,10 uM,24 h,5,66,71,2,0,0,0,NPC
BRD-M28563253_10uM_6h,BRD-M28563253,10 uM,6 h,5,54,59,2,0,0,0,NPC
BRD-K99554241_10uM_24h,BRD-K99554241,10 uM,24 h,5,66,71,2,3,3,0,NPC
BRD-M29370314_10uM_24h,BRD-M29370314,10 uM,24 h,5,66,71,2,0,0,0,NPC
farnesylpyrophosphate_10uM_6h,farnesylpyrophosphate,10 uM,6 h,5,54,59,2,0,0,0,NPC
BRD-K37365015_10uM_24h,BRD-K37365015,10 uM,24 h,5,66,71,2,80,27,53,NPC
BRD-A09053961_10uM_24h,BRD-A09053961,10 uM,24 h,5,66,71,2,0,0,0,NPC
2-aminotetralin_10uM_24h,2-aminotetralin,10 uM,24 h,5,66,71,2,0,0,0,NPC
BAY-36-7620_10uM_6h,BAY-36-7620,10 uM,6 h,5,54,59,2,0,0,0,NPC
BRD-A39986918_10uM_24h,BRD-A39986918,10 uM,24 h,5,66,71,2,0,0,0,NPC
BRD-K72015216_10uM_6h,BRD-K72015216,10 uM,6 h,5,54,59,2,0,0,0,NPC
BRD-A26333730_10uM_6h,BRD-A26333730,10 uM,6 h,5,54,59,2,0,0,0,NPC
isosalsoline_10uM_6h,isosalsoline,10 uM,6 h,5,54,59,2,1,1,0,NPC
BRD-A82323890_10uM_24h,BRD-A82323890,10 uM,24 h,5,66,71,2,1,1,0,NPC
LBH-589_10uM_24h,LBH-589,10 uM,24 h,5,66,71,2,395,190,205,NPC
BRD-K23986500_10uM_24h,BRD-K23986500,10 uM,24 h,5,66,71,2,5,3,2,NPC
BRD-K55332332_10uM_24h,BRD-K55332332,10 uM,24 h,5,66,71,2,6,5,1,NPC
BRD-A78236793_10uM_24h,BRD-A78236793,10 uM,24 h,5,66,71,2,7,2,5,NPC
BRD-A17081056_10uM_6h,BRD-A17081056,10 uM,6 h,5,54,59,2,4,2,2,NPC
mevalonic-acid_10uM_6h,mevalonic-acid,10 uM,6 h,5,54,59,2,0,0,0,NPC
BRD-A61866602_10uM_6h,BRD-A61866602,10 uM,6 h,5,54,59,2,1,0,1,NPC
BRD-K65981456_10uM_24h,BRD-K65981456,10 uM,24 h,5,66,71,2,0,0,0,NPC
SR-147778_10uM_6h,SR-147778,10 uM,6 h,5,54,59,2,0,0,0,NPC
BRD-K49889622_10uM_24h,BRD-K49889622,10 uM,24 h,5,66,71,2,3,1,2,NPC
BRD-K42823101_10uM_24h,BRD-K42823101,10 uM,24 h,5,66,71,2,0,0,0,NPC
tyramine_10uM_24h,tyramine,10 uM,24 h,5,66,71,2,0,0,0,NPC
desmethyl-DASB_10uM_6h,desmethyl-DASB,10 uM,6 h,5,54,59,2,1,0,1,NPC
BRD-K49889622_10uM_6h,BRD-K49889622,10 uM,6 h,5,54,59,2,0,0,0,NPC
BRD-K65213718_10uM_24h,BRD-K65213718,10 uM,24 h,5,66,71,2,1,0,1,NPC
GGTI-2133_10uM_24h,GGTI-2133,10 uM,24 h,5,66,71,2,2,0,2,NPC
BRD-K55332332_10uM_6h,BRD-K55332332,10 uM,6 h,5,54,59,2,0,0,0,NPC
gingerol_10uM_6h,gingerol,10 uM,6 h,5,47,52,2,17,13,4,NPC
epidepride_10uM_24h,epidepride,10 uM,24 h,5,66,71,2,0,0,0,NPC
YM-09151-2_10uM_24h,YM-09151-2,10 uM,24 h,5,66,71,2,0,0,0,NPC
BRD-K12482929_10uM_24h,BRD-K12482929,10 uM,24 h,5,66,71,2,1,1,0,NPC
BRD-K83836748_10uM_24h,BRD-K83836748,10 uM,24 h,5,66,71,2,0,0,0,NPC
BRD-K92326486_10uM_24h,BRD-K92326486,10 uM,24 h,5,66,71,2,3,1,2,NPC
1-methylisoquinoline_10uM_24h,1-methylisoquinoline,10 uM,24 h,5,66,71,2,1,0,1,NPC
RTI-55_10uM_6h,RTI-55,10 uM,6 h,5,54,59,2,1,0,1,NPC
BRD-K38720323_10uM_6h,BRD-K38720323,10 uM,6 h,5,54,59,2,3,3,0,NPC
farnesylpyrophosphate_10uM_24h,farnesylpyrophosphate,10 uM,24 h,5,66,71,2,1,1,0,NPC
BRD-M16214895_10uM_24h,BRD-M16214895,10 uM,24 h,5,66,71,2,22,20,2,NPC
BRD-K10939925_10uM_6h,BRD-K10939925,10 uM,6 h,5,54,59,2,0,0,0,NPC
BRD-K18436203_10uM_24h,BRD-K18436203,10 uM,24 h,5,66,71,2,3,1,2,NPC
BRD-U57440914_10uM_6h,BRD-U57440914,10 uM,6 h,5,54,59,2,1,1,0,NPC
BRD-A42187224_10uM_24h,BRD-A42187224,10 uM,24 h,5,66,71,2,0,0,0,NPC
BRD-A01295252_10uM_6h,BRD-A01295252,10 uM,6 h,5,54,59,2,10,0,10,NPC
velnacrine_10uM_24h,velnacrine,10 uM,24 h,5,66,71,2,0,0,0,NPC
RTI-55_10uM_24h,RTI-55,10 uM,24 h,5,66,71,2,1,0,1,NPC
YM-09151-2_10uM_6h,YM-09151-2,10 uM,6 h,5,54,59,2,0,0,0,NPC
BRD-K20151898_10uM_6h,BRD-K20151898,10 uM,6 h,5,54,59,2,0,0,0,NPC
aminobenztropine_10uM_24h,aminobenztropine,10 uM,24 h,5,66,71,2,1,1,0,NPC
BRD-K04877770_10uM_6h,BRD-K04877770,10 uM,6 h,5,54,59,2,1,1,0,NPC
BRD-K61260019_10uM_24h,BRD-K61260019,10 uM,24 h,5,66,71,2,3,1,2,NPC
BRD-K12482929_10uM_6h,BRD-K12482929,10 uM,6 h,5,54,59,2,1,1,0,NPC
BRD-K39981244_10uM_24h,BRD-K39981244,10 uM,24 h,5,66,71,2,0,0,0,NPC
BRD-U71399930_10uM_24h,BRD-U71399930,10 uM,24 h,5,66,71,2,28,20,8,NPC
BRD-A27924917_10uM_6h,BRD-A27924917,10 uM,6 h,5,54,59,2,0,0,0,NPC
BRD-K42823101_10uM_6h,BRD-K42823101,10 uM,6 h,5,54,59,2,1,1,0,NPC
salsolinol_10uM_6h,salsolinol,10 uM,6 h,5,54,59,2,1,0,1,NPC
BRD-K96834847_10uM_24h,BRD-K96834847,10 uM,24 h,5,66,71,2,2,1,1,NPC
BRD-K80062189_10uM_24h,BRD-K80062189,10 uM,24 h,5,66,71,2,177,69,108,NPC
BRD-A12426960_10uM_6h,BRD-A12426960,10 uM,6 h,5,54,59,2,2,2,0,NPC
BRD-K09887211_10uM_24h,BRD-K09887211,10 uM,24 h,5,66,71,2,0,0,0,NPC
BRD-A40163033_10uM_6h,BRD-A40163033,10 uM,6 h,5,54,59,2,0,0,0,NPC
BRD-K45845523_10uM_6h,BRD-K45845523,10 uM,6 h,5,54,59,2,33,14,19,NPC
BRD-K91844626_10uM_6h,BRD-K91844626,10 uM,6 h,5,54,59,2,6,2,4,NPC
BRD-K41824522_10uM_6h,BRD-K41824522,10 uM,6 h,5,54,59,2,0,0,0,NPC
BRD-K71339761_10uM_6h,BRD-K71339761,10 uM,6 h,5,54,59,2,42,16,26,NPC
BRD-A77098556_10uM_6h,BRD-A77098556,10 uM,6 h,5,54,59,2,2,0,2,NPC
BRD-K92159000_10uM_6h,BRD-K92159000,10 uM,6 h,5,54,59,2,4,3,1,NPC
BRD-K69458799_10uM_24h,BRD-K69458799,10 uM,24 h,5,66,71,2,0,0,0,NPC
BRD-K76941385_10uM_6h,BRD-K76941385,10 uM,6 h,5,54,59,2,0,0,0,NPC
SR-147778_10uM_24h,SR-147778,10 uM,24 h,5,66,71,2,1,1,0,NPC
BRD-A18795974_10uM_6h,BRD-A18795974,10 uM,6 h,5,54,59,2,0,0,0,NPC
APEC_10uM_24h,APEC,10 uM,24 h,5,66,71,2,0,0,0,NPC
W-7_10uM_6h,W-7,10 uM,6 h,5,54,59,2,9,4,5,NPC
BRD-A77864279_10uM_6h,BRD-A77864279,10 uM,6 h,5,54,59,2,0,0,0,NPC
BRD-K53249762_10uM_6h,BRD-K53249762,10 uM,6 h,5,54,59,2,0,0,0,NPC
beta-alanine_10uM_6h,beta-alanine,10 uM,6 h,5,54,59,2,0,0,0,NPC
BRD-K52453128_10uM_6h,BRD-K52453128,10 uM,6 h,5,54,59,2,1,0,1,NPC
BRD-K23922020_10uM_24h,BRD-K23922020,10 uM,24 h,4,39,43,1,1,0,1,NPC
BRD-K04546108_10uM_24h,BRD-K04546108,10 uM,24 h,4,39,43,1,171,74,97,NPC
fusaric-acid_10uM_24h,fusaric-acid,10 uM,24 h,4,40,44,1,69,27,42,NPC
BRD-K88741031_10uM_24h,BRD-K88741031,10 uM,24 h,4,40,44,1,148,79,69,NPC
DAPT-GSI-IX_10uM_24h,DAPT-GSI-IX,10 uM,24 h,4,40,44,1,0,0,0,NPC
BRD-K16233984_10uM_24h,BRD-K16233984,10 uM,24 h,4,39,43,1,0,0,0,NPC
BRD-K81807412_10uM_24h,BRD-K81807412,10 uM,24 h,4,40,44,1,0,0,0,NPC
veratridine_10uM_24h,veratridine,10 uM,24 h,4,39,43,1,0,0,0,NPC
ML-3163_10uM_24h,ML-3163,10 uM,24 h,4,40,44,1,0,0,0,NPC
prostaglandin-b2_10uM_24h,prostaglandin-b2,10 uM,24 h,4,40,44,1,0,0,0,NPC
W-9_10uM_24h,W-9,10 uM,24 h,4,39,43,1,228,91,137,NPC
BRD-K37883585_10uM_24h,BRD-K37883585,10 uM,24 h,4,40,44,1,0,0,0,NPC
BRD-K36614862_10uM_24h,BRD-K36614862,10 uM,24 h,4,40,44,1,0,0,0,NPC
cyproterone_10uM_24h,cyproterone,10 uM,24 h,4,37,41,1,0,0,0,NPC
RG-13022_10uM_24h,RG-13022,10 uM,24 h,4,39,43,1,0,0,0,NPC
BRD-K59058766_10uM_24h,BRD-K59058766,10 uM,24 h,4,40,44,1,80,27,53,NPC
ergocryptine_10uM_24h,ergocryptine,10 uM,24 h,4,40,44,1,0,0,0,NPC
seneciphylline_10uM_24h,seneciphylline,10 uM,24 h,4,40,44,1,205,76,129,NPC
BRD-K89595132_10uM_24h,BRD-K89595132,10 uM,24 h,4,39,43,1,7,2,5,NPC
BRD-K72166146_10uM_24h,BRD-K72166146,10 uM,24 h,4,39,43,1,1,0,1,NPC
BRD-K97440753_10uM_24h,BRD-K97440753,10 uM,24 h,4,40,44,1,1,0,1,NPC
BRD-K78075916_10uM_24h,BRD-K78075916,10 uM,24 h,4,18,22,1,19,7,12,NPC
LY-320135_10uM_24h,LY-320135,10 uM,24 h,4,39,43,1,1,1,0,NPC
candesartan-cilextil_10uM_24h,candesartan-cilextil,10 uM,24 h,4,37,41,1,0,0,0,NPC
staurosporine_10uM_6h,staurosporine,10 uM,6 h,4,39,43,2,189,39,150,NPC
GR-89696_10uM_24h,GR-89696,10 uM,24 h,4,40,44,1,0,0,0,NPC
rotenonic-acid_10uM_24h,rotenonic-acid,10 uM,24 h,4,40,44,1,0,0,0,NPC
tubaic-acid_10uM_24h,tubaic-acid,10 uM,24 h,4,37,41,1,5,2,3,NPC
sappanone-a_10uM_24h,sappanone-a,10 uM,24 h,4,37,41,1,4,3,1,NPC
BRD-K55242988_10uM_6h,BRD-K55242988,10 uM,6 h,4,44,48,2,65,35,30,NPC
BH3I-1_10uM_24h,BH3I-1,10 uM,24 h,4,39,43,1,82,23,59,NPC
lobelanidine_10uM_24h,lobelanidine,10 uM,24 h,4,39,43,1,4,2,2,NPC
skimmianine_10uM_24h,skimmianine,10 uM,24 h,4,40,44,1,0,0,0,NPC
ganglioside_10uM_24h,ganglioside,10 uM,24 h,4,39,43,1,1,1,0,NPC
aminogenistein_10uM_24h,aminogenistein,10 uM,24 h,4,39,43,1,47,28,19,NPC
modafinil_10uM_24h,modafinil,10 uM,24 h,4,37,41,1,1,1,0,NPC
BRD-A95513702_10uM_24h,BRD-A95513702,10 uM,24 h,4,37,41,1,20,14,6,NPC
kynuramine_10uM_24h,kynuramine,10 uM,24 h,4,40,44,1,124,62,62,NPC
BRD-K50311478_10uM_24h,BRD-K50311478,10 uM,24 h,4,40,44,1,1,1,0,NPC
BRD-K60932973_10uM_24h,BRD-K60932973,10 uM,24 h,4,39,43,1,17,12,5,NPC
coumestrol_10uM_24h,coumestrol,10 uM,24 h,4,40,44,1,0,0,0,NPC
testosterone-propionate_10uM_24h,testosterone-propionate,10 uM,24 h,4,37,41,1,10,9,1,NPC
benzopurpurin-4b_10uM_24h,benzopurpurin-4b,10 uM,24 h,4,37,41,1,4,2,2,NPC
quercetagetin_10uM_24h,quercetagetin,10 uM,24 h,4,37,41,1,0,0,0,NPC
TC-1_10uM_24h,TC-1,10 uM,24 h,4,37,41,1,0,0,0,NPC
BRD-K76274772_10uM_24h,BRD-K76274772,10 uM,24 h,4,39,43,1,0,0,0,NPC
adipiodone_10uM_24h,adipiodone,10 uM,24 h,4,39,43,1,0,0,0,NPC
BRD-K47535255_10uM_24h,BRD-K47535255,10 uM,24 h,4,56,60,2,28,19,9,NPC
xanthoxyline_10uM_24h,xanthoxyline,10 uM,24 h,4,37,41,1,2,2,0,NPC
MDL-28170_10uM_24h,MDL-28170,10 uM,24 h,4,39,43,1,14,3,11,NPC
BRD-K24053527_10uM_24h,BRD-K24053527,10 uM,24 h,4,39,43,1,0,0,0,NPC
dibutyrylcyclic-gmp_10uM_24h,dibutyrylcyclic-gmp,10 uM,24 h,4,37,41,1,0,0,0,NPC
BRD-K36651625_10uM_6h,BRD-K36651625,10 uM,6 h,4,44,48,2,1,0,1,NPC
quinisocaine_10uM_24h,quinisocaine,10 uM,24 h,4,39,43,1,4,1,3,NPC
calycanthine_10uM_24h,calycanthine,10 uM,24 h,4,39,43,1,11,0,11,NPC
IAA-94_10uM_24h,IAA-94,10 uM,24 h,4,40,44,1,0,0,0,NPC
BRD-K63938928_10uM_24h,BRD-K63938928,10 uM,24 h,4,39,43,1,9,2,7,NPC
indolophenanthridine_10uM_24h,indolophenanthridine,10 uM,24 h,4,40,44,1,3,2,1,NPC
ginsenoside_10uM_24h,ginsenoside,10 uM,24 h,4,39,43,1,0,0,0,NPC
leoidin_10uM_24h,leoidin,10 uM,24 h,4,40,44,1,0,0,0,NPC
BRD-K76064317_10uM_24h,BRD-K76064317,10 uM,24 h,4,39,43,1,2,2,0,NPC
beta-CCP_10uM_24h,beta-CCP,10 uM,24 h,4,40,44,1,1,1,0,NPC
hinokitiol_10uM_24h,hinokitiol,10 uM,24 h,4,40,44,1,12,5,7,NPC
LY-288513_10uM_24h,LY-288513,10 uM,24 h,4,40,44,1,0,0,0,NPC
linoleamide_10uM_24h,linoleamide,10 uM,24 h,4,39,43,1,5,3,2,NPC
BRD-K60174629_10uM_24h,BRD-K60174629,10 uM,24 h,4,39,43,1,11,3,8,NPC
deoxyandirobin_10uM_24h,deoxyandirobin,10 uM,24 h,4,39,43,1,1,1,0,NPC
decafluorobutane_10uM_24h,decafluorobutane,10 uM,24 h,4,39,43,1,0,0,0,NPC
CGP-52432_10uM_24h,CGP-52432,10 uM,24 h,4,39,43,1,5,1,4,NPC
BRD-K76293260_10uM_24h,BRD-K76293260,10 uM,24 h,4,39,43,1,14,2,12,NPC
lawsone_10uM_24h,lawsone,10 uM,24 h,4,39,43,1,0,0,0,NPC
carbofuran_10uM_24h,carbofuran,10 uM,24 h,4,39,43,1,0,0,0,NPC
pseudopelletierine_10uM_24h,pseudopelletierine,10 uM,24 h,4,37,41,1,0,0,0,NPC
BRD-K07079548_10uM_24h,BRD-K07079548,10 uM,24 h,4,39,43,1,25,4,21,NPC
tetramethylsilane_10uM_24h,tetramethylsilane,10 uM,24 h,4,40,44,1,4,1,3,NPC
BRD-K39172790_10uM_6h,BRD-K39172790,10 uM,6 h,4,44,48,2,2,2,0,NPC
BRD-K71860425_10uM_24h,BRD-K71860425,10 uM,24 h,4,39,43,1,0,0,0,NPC
DY-131_10uM_24h,DY-131,10 uM,24 h,4,39,43,1,74,18,56,NPC
valyltryptophan_10uM_24h,valyltryptophan,10 uM,24 h,4,39,43,1,1,0,1,NPC
scoulerine_10uM_24h,scoulerine,10 uM,24 h,4,39,43,1,139,62,77,NPC
dibenzepin_10uM_24h,dibenzepin,10 uM,24 h,4,39,43,1,0,0,0,NPC
BRD-K49061529_10uM_24h,BRD-K49061529,10 uM,24 h,4,40,44,1,76,39,37,NPC
BRD-K03670461_10uM_24h,BRD-K03670461,10 uM,24 h,4,40,44,1,5,4,1,NPC
reserpic-acid_10uM_24h,reserpic-acid,10 uM,24 h,4,40,44,1,1,1,0,NPC
ecopipam_10uM_24h,ecopipam,10 uM,24 h,4,40,44,1,0,0,0,NPC
CGP-20712_10uM_24h,CGP-20712,10 uM,24 h,4,37,41,1,0,0,0,NPC
BRD-K89997465_10uM_6h,BRD-K89997465,10 uM,6 h,4,44,48,2,115,26,89,NPC
etamivan_10uM_24h,etamivan,10 uM,24 h,4,37,41,1,1,0,1,NPC
maackiain_10uM_24h,maackiain,10 uM,24 h,4,39,43,1,24,12,12,NPC
BRD-K95992530_10uM_24h,BRD-K95992530,10 uM,24 h,4,40,44,1,0,0,0,NPC
BRD-K68873215_10uM_24h,BRD-K68873215,10 uM,24 h,4,37,41,1,34,17,17,NPC
BRD-K95676198_10uM_24h,BRD-K95676198,10 uM,24 h,4,40,44,1,0,0,0,NPC
mammea-a_10uM_24h,mammea-a,10 uM,24 h,4,40,44,1,2,1,1,NPC
BRD-A86146706_10uM_24h,BRD-A86146706,10 uM,24 h,4,58,62,2,262,117,145,NPC
dephostatin_10uM_24h,dephostatin,10 uM,24 h,4,40,44,1,0,0,0,NPC
BRD-K72541103_10uM_24h,BRD-K72541103,10 uM,24 h,4,39,43,1,3,1,2,NPC
BRD-K93541117_10uM_24h,BRD-K93541117,10 uM,24 h,4,40,44,1,66,29,37,NPC
BRD-A39747742_10uM_24h,BRD-A39747742,10 uM,24 h,4,39,43,1,0,0,0,NPC
graveoline_10uM_24h,graveoline,10 uM,24 h,4,40,44,1,10,6,4,NPC
denbufylline_10uM_24h,denbufylline,10 uM,24 h,4,40,44,1,0,0,0,NPC
BRD-K25836724_10uM_24h,BRD-K25836724,10 uM,24 h,4,37,41,1,2,1,1,NPC
TC-2559_10uM_24h,TC-2559,10 uM,24 h,4,40,44,1,0,0,0,NPC
BRD-K47869605_10uM_24h,BRD-K47869605,10 uM,24 h,4,37,41,1,367,155,212,NPC
CP-55940_10uM_24h,CP-55940,10 uM,24 h,4,39,43,1,28,9,19,NPC
hydrastine_10uM_24h,hydrastine,10 uM,24 h,4,37,41,1,1,1,0,NPC
isoreserpine_10uM_24h,isoreserpine,10 uM,24 h,4,39,43,1,96,22,74,NPC
BRD-K97118047_10uM_24h,BRD-K97118047,10 uM,24 h,4,40,44,1,0,0,0,NPC
hispidin_10uM_24h,hispidin,10 uM,24 h,4,39,43,1,101,29,72,NPC
flavokavain-b_10uM_24h,flavokavain-b,10 uM,24 h,4,37,41,1,7,3,4,NPC
bis-tyrphostin_10uM_24h,bis-tyrphostin,10 uM,24 h,4,39,43,1,17,16,1,NPC
ponalrestat_10uM_24h,ponalrestat,10 uM,24 h,4,39,43,1,0,0,0,NPC
EMF-sumo1-11_10uM_24h,EMF-sumo1-11,10 uM,24 h,4,29,33,1,138,39,99,NPC
austricine_10uM_24h,austricine,10 uM,24 h,4,39,43,1,9,6,3,NPC
BRD-A63667919_10uM_24h,BRD-A63667919,10 uM,24 h,4,40,44,1,1,1,0,NPC
VUF-5681_10uM_24h,VUF-5681,10 uM,24 h,4,39,43,1,6,2,4,NPC
herniarin_10uM_24h,herniarin,10 uM,24 h,4,39,43,1,0,0,0,NPC
rescinnamine_10uM_24h,rescinnamine,10 uM,24 h,4,39,43,1,0,0,0,NPC
SKF-104078_10uM_6h,SKF-104078,10 uM,6 h,4,44,48,2,23,3,20,NPC
talampicillin_10uM_24h,talampicillin,10 uM,24 h,4,39,43,1,6,3,3,NPC
BRD-K71726959_10uM_24h,BRD-K71726959,10 uM,24 h,4,39,43,1,77,19,58,NPC
GR-55562_10uM_24h,GR-55562,10 uM,24 h,4,40,44,1,11,9,2,NPC
deltaline_10uM_24h,deltaline,10 uM,24 h,4,39,43,1,73,12,61,NPC
cardiogenol-c_10uM_24h,cardiogenol-c,10 uM,24 h,4,39,43,1,0,0,0,NPC
T-98475_10uM_24h,T-98475,10 uM,24 h,4,39,43,1,3,2,1,NPC
BRD-A51929314_10uM_24h,BRD-A51929314,10 uM,24 h,4,39,43,1,1,0,1,NPC
farnesylthiotriazole_10uM_24h,farnesylthiotriazole,10 uM,24 h,4,40,44,1,5,2,3,NPC
lumicolchicine_10uM_24h,lumicolchicine,10 uM,24 h,4,39,43,1,1,1,0,NPC
tyrphostin-47_10uM_24h,tyrphostin-47,10 uM,24 h,4,39,43,1,65,14,51,NPC
tetramethyl-haematoxylone_10uM_24h,tetramethyl-haematoxylone,10 uM,24 h,4,40,44,1,1,1,0,NPC
ML-7_10uM_24h,ML-7,10 uM,24 h,4,39,43,1,0,0,0,NPC
BRD-A36066264_10uM_24h,BRD-A36066264,10 uM,24 h,4,40,44,1,3,2,1,NPC
alclometasone_10uM_24h,alclometasone,10 uM,24 h,4,37,41,1,0,0,0,NPC
AG-879_10uM_24h,AG-879,10 uM,24 h,4,39,43,1,83,42,41,NPC
ergometrine_10uM_24h,ergometrine,10 uM,24 h,4,39,43,1,0,0,0,NPC
EMD-41000_10uM_24h,EMD-41000,10 uM,24 h,4,40,44,1,1,0,1,NPC
LY-2183240_10uM_24h,LY-2183240,10 uM,24 h,4,40,44,1,216,105,111,NPC
foliosidine_10uM_24h,foliosidine,10 uM,24 h,4,39,43,1,1,0,1,NPC
naproxol_10uM_24h,naproxol,10 uM,24 h,4,37,41,1,0,0,0,NPC
D-64406_10uM_24h,D-64406,10 uM,24 h,4,39,43,1,39,23,16,NPC
spiramide_10uM_24h,spiramide,10 uM,24 h,4,40,44,1,5,4,1,NPC
deguelin_10uM_24h,deguelin,10 uM,24 h,4,37,41,1,22,12,10,NPC
iopanoic-acid_10uM_24h,iopanoic-acid,10 uM,24 h,4,37,41,1,0,0,0,NPC
arachidonamide_10uM_24h,arachidonamide,10 uM,24 h,4,39,43,1,2,2,0,NPC
BRD-K14441456_10uM_24h,BRD-K14441456,10 uM,24 h,4,39,43,1,219,84,135,NPC
BRD-K97330509_10uM_24h,BRD-K97330509,10 uM,24 h,4,40,44,1,0,0,0,NPC
LY-255283_10uM_24h,LY-255283,10 uM,24 h,4,40,44,1,186,93,93,NPC
cinnarizine_10uM_24h,cinnarizine,10 uM,24 h,4,39,43,1,2,0,2,NPC
BRD-A06276885_10uM_24h,BRD-A06276885,10 uM,24 h,4,40,44,1,13,5,8,NPC
KU-14R_10uM_24h,KU-14R,10 uM,24 h,4,39,43,1,0,0,0,NPC
BRD-A66861218_10uM_24h,BRD-A66861218,10 uM,24 h,4,40,44,1,1,0,1,NPC
oxindole-I_10uM_24h,oxindole-I,10 uM,24 h,4,39,43,1,6,3,3,NPC
BRD-K28761384_10uM_24h,BRD-K28761384,10 uM,24 h,4,39,43,1,3,2,1,NPC
Ro-04-6790_10uM_24h,Ro-04-6790,10 uM,24 h,4,37,41,1,0,0,0,NPC
BRD-A49680073_10uM_24h,BRD-A49680073,10 uM,24 h,4,40,44,1,0,0,0,NPC
BRD-A04553218_10uM_24h,BRD-A04553218,10 uM,24 h,4,37,41,1,0,0,0,NPC
BRD-A53131506_10uM_24h,BRD-A53131506,10 uM,24 h,4,37,41,1,3,2,1,NPC
BRD-K84421793_10uM_24h,BRD-K84421793,10 uM,24 h,4,40,44,1,0,0,0,NPC
tramadol_10uM_24h,tramadol,10 uM,24 h,4,37,41,1,0,0,0,NPC
GR-32191_10uM_24h,GR-32191,10 uM,24 h,4,39,43,1,31,11,20,NPC
BRD-K54906270_10uM_24h,BRD-K54906270,10 uM,24 h,4,40,44,1,1,1,0,NPC
CGS-12066B_10uM_24h,CGS-12066B,10 uM,24 h,4,40,44,1,0,0,0,NPC
chlortalidone_10uM_24h,chlortalidone,10 uM,24 h,4,39,43,1,3,0,3,NPC
BRD-K10136726_10uM_24h,BRD-K10136726,10 uM,24 h,4,39,43,1,0,0,0,NPC
prothionamide_10uM_24h,prothionamide,10 uM,24 h,4,37,41,1,1,0,1,NPC
BRD-K74430258_10uM_24h,BRD-K74430258,10 uM,24 h,4,39,43,1,6,0,6,NPC
L-750667_10uM_24h,L-750667,10 uM,24 h,4,39,43,1,0,0,0,NPC
BRD-A14999564_10uM_6h,BRD-A14999564,10 uM,6 h,4,44,48,2,0,0,0,NPC
BRD-K96527333_10uM_24h,BRD-K96527333,10 uM,24 h,4,40,44,1,0,0,0,NPC
eicosatrienoic-acid_10uM_24h,eicosatrienoic-acid,10 uM,24 h,4,39,43,1,2,1,1,NPC
tebuthiuron_10uM_24h,tebuthiuron,10 uM,24 h,4,37,41,1,3,2,1,NPC
rhamnetin_10uM_24h,rhamnetin,10 uM,24 h,4,37,41,1,35,15,20,NPC
BRD-K34533029_10uM_24h,BRD-K34533029,10 uM,24 h,4,39,43,1,16,15,1,NPC
coumaric-acid_10uM_24h,coumaric-acid,10 uM,24 h,4,40,44,1,11,4,7,NPC
AG-592_10uM_24h,AG-592,10 uM,24 h,4,40,44,1,105,45,60,NPC
aliskiren_10uM_24h,aliskiren,10 uM,24 h,4,37,41,1,1,0,1,NPC
BRD-A84389633_10uM_24h,BRD-A84389633,10 uM,24 h,4,40,44,1,1,1,0,NPC
BRD-K19136521_10uM_24h,BRD-K19136521,10 uM,24 h,4,37,41,1,122,52,70,NPC
BG-1024_10uM_24h,BG-1024,10 uM,24 h,4,41,45,2,267,95,172,NPC
ungerine_10uM_24h,ungerine,10 uM,24 h,4,39,43,1,0,0,0,NPC
TCB2_10uM_24h,TCB2,10 uM,24 h,4,37,41,1,0,0,0,NPC
BAPTA-AM_10uM_24h,BAPTA-AM,10 uM,24 h,4,39,43,1,7,5,2,NPC
BRD-K01815685_10uM_24h,BRD-K01815685,10 uM,24 h,4,37,41,1,0,0,0,NPC
AG-494_10uM_24h,AG-494,10 uM,24 h,4,40,44,1,3,3,0,NPC
dipropyl-5ct_10uM_24h,dipropyl-5ct,10 uM,24 h,4,40,44,1,0,0,0,NPC
ricinine_10uM_24h,ricinine,10 uM,24 h,4,40,44,1,0,0,0,NPC
BRD-A89208012_10uM_24h,BRD-A89208012,10 uM,24 h,4,40,44,1,0,0,0,NPC
butylparaben_10uM_24h,butylparaben,10 uM,24 h,4,39,43,1,0,0,0,NPC
ciclacillin_10uM_24h,ciclacillin,10 uM,24 h,4,40,44,1,0,0,0,NPC
cephaeline_10uM_24h,cephaeline,10 uM,24 h,4,40,44,1,402,176,226,NPC
deoxyrhapontin_10uM_24h,deoxyrhapontin,10 uM,24 h,4,37,41,1,0,0,0,NPC
BRD-K87166736_10uM_24h,BRD-K87166736,10 uM,24 h,4,56,60,2,0,0,0,NPC
BRD-K15164005_10uM_24h,BRD-K15164005,10 uM,24 h,4,40,44,1,11,3,8,NPC
fillalbin_10uM_24h,fillalbin,10 uM,24 h,4,40,44,1,3,3,0,NPC
MDM2-inhibitor_10uM_24h,MDM2-inhibitor,10 uM,24 h,4,39,43,1,65,22,43,NPC
BRD-A01593789_10uM_24h,BRD-A01593789,10 uM,24 h,4,37,41,1,137,61,76,NPC
dicyclohexylurea_10uM_24h,dicyclohexylurea,10 uM,24 h,4,37,41,1,0,0,0,NPC
vitexin_10uM_24h,vitexin,10 uM,24 h,4,37,41,1,1,0,1,NPC
norketamine_10uM_24h,norketamine,10 uM,24 h,4,39,43,1,0,0,0,NPC
EMD-84_10uM_24h,EMD-84,10 uM,24 h,4,40,44,1,1,1,0,NPC
emodic-acid_10uM_24h,emodic-acid,10 uM,24 h,4,40,44,1,62,19,43,NPC
L-732138_10uM_24h,L-732138,10 uM,24 h,4,40,44,1,2,1,1,NPC
ryanodine_10uM_24h,ryanodine,10 uM,24 h,4,39,43,1,1,0,1,NPC
tyrphostin_10uM_24h,tyrphostin,10 uM,24 h,4,39,43,1,36,26,10,NPC
ivachtin_10uM_24h,ivachtin,10 uM,24 h,4,39,43,1,0,0,0,NPC
glibenclamide_10uM_24h,glibenclamide,10 uM,24 h,4,40,44,1,0,0,0,NPC
BCL2-inhibitor_10uM_24h,BCL2-inhibitor,10 uM,24 h,4,39,43,1,22,14,8,NPC
BRD-K09635134_10uM_24h,BRD-K09635134,10 uM,24 h,4,39,43,1,7,0,7,NPC
syrosingopine_10uM_24h,syrosingopine,10 uM,24 h,4,39,43,1,42,7,35,NPC
evoxine_10uM_24h,evoxine,10 uM,24 h,4,39,43,1,1,0,1,NPC
picrotoxin_10uM_24h,picrotoxin,10 uM,24 h,4,37,41,1,0,0,0,NPC
methyllidocaine_10uM_24h,methyllidocaine,10 uM,24 h,4,39,43,1,6,3,3,NPC
BRD-K07888196_10uM_24h,BRD-K07888196,10 uM,24 h,4,39,43,1,171,53,118,NPC
BRD-K06024458_10uM_24h,BRD-K06024458,10 uM,24 h,4,39,43,1,53,14,39,NPC
mead-acid_10uM_24h,mead-acid,10 uM,24 h,4,40,44,1,0,0,0,NPC
RK-682_10uM_24h,RK-682,10 uM,24 h,4,37,41,1,2,1,1,NPC
GR-46611_10uM_24h,GR-46611,10 uM,24 h,4,40,44,1,0,0,0,NPC
BRD-K33211335_10uM_24h,BRD-K33211335,10 uM,24 h,4,40,44,1,0,0,0,NPC
RG-14620_10uM_24h,RG-14620,10 uM,24 h,4,37,41,1,0,0,0,NPC
delcorine_10uM_24h,delcorine,10 uM,24 h,4,39,43,1,1,0,1,NPC
cuneatin_10uM_24h,cuneatin,10 uM,24 h,4,40,44,1,0,0,0,NPC
BRD-K45330754_10uM_24h,BRD-K45330754,10 uM,24 h,4,39,43,1,1,0,1,NPC
SB-205607_10uM_24h,SB-205607,10 uM,24 h,4,39,43,1,1,0,1,NPC
PNU-96415E_10uM_24h,PNU-96415E,10 uM,24 h,4,40,44,1,1,0,1,NPC
pseudoephedrine_10uM_24h,pseudoephedrine,10 uM,24 h,4,40,44,1,1,0,1,NPC
BRD-K92073408_10uM_24h,BRD-K92073408,10 uM,24 h,4,40,44,1,28,12,16,NPC
O-2050_10uM_24h,O-2050,10 uM,24 h,4,39,43,1,25,4,21,NPC
BRD-A42610307_10uM_24h,BRD-A42610307,10 uM,24 h,4,50,54,2,0,0,0,NPC
BRD-A49765801_10uM_24h,BRD-A49765801,10 uM,24 h,4,37,41,1,0,0,0,NPC
dihydrosamidin_10uM_24h,dihydrosamidin,10 uM,24 h,4,40,44,1,41,23,18,NPC
BRD-K63792901_10uM_24h,BRD-K63792901,10 uM,24 h,4,40,44,1,0,0,0,NPC
U-74389F_10uM_24h,U-74389F,10 uM,24 h,4,39,43,1,1,0,1,NPC
CCT036477_10uM_24h,CCT036477,10 uM,24 h,4,40,44,2,153,41,112,NPC
dpn_10uM_24h,dpn,10 uM,24 h,4,39,43,1,2,0,2,NPC
meclocycline_10uM_24h,meclocycline,10 uM,24 h,4,39,43,1,47,7,40,NPC
TER-14687_10uM_24h,TER-14687,10 uM,24 h,4,40,44,1,8,5,3,NPC
W-13_10uM_24h,W-13,10 uM,24 h,4,39,43,1,82,22,60,NPC
BRD-K70980943_10uM_6h,BRD-K70980943,10 uM,6 h,4,43,47,2,0,0,0,NPC
PP-3_10uM_24h,PP-3,10 uM,24 h,4,39,43,1,16,6,10,NPC
hippeastrine_10uM_24h,hippeastrine,10 uM,24 h,4,40,44,1,0,0,0,NPC
BRD-K78844995_10uM_24h,BRD-K78844995,10 uM,24 h,4,40,44,1,1,1,0,NPC
IC-261_10uM_24h,IC-261,10 uM,24 h,4,39,43,1,165,74,91,NPC
lysergol_10uM_24h,lysergol,10 uM,24 h,4,39,43,1,0,0,0,NPC
phentermine_10uM_24h,phentermine,10 uM,24 h,4,37,41,1,1,1,0,NPC
LY-278584_10uM_24h,LY-278584,10 uM,24 h,4,39,43,1,3,0,3,NPC
BRD-K02581333_10uM_24h,BRD-K02581333,10 uM,24 h,4,37,41,1,4,3,1,NPC
fluprostenol_10uM_24h,fluprostenol,10 uM,24 h,4,40,44,1,0,0,0,NPC
STO-609_10uM_24h,STO-609,10 uM,24 h,4,39,43,1,0,0,0,NPC
angiogenesis-inhibitor_10uM_24h,angiogenesis-inhibitor,10 uM,24 h,4,39,43,1,22,14,8,NPC
PSB-069_10uM_24h,PSB-069,10 uM,24 h,4,37,41,1,6,4,2,NPC
H-8_10uM_24h,H-8,10 uM,24 h,4,40,44,1,0,0,0,NPC
epicatechin_10uM_24h,epicatechin,10 uM,24 h,4,37,41,1,0,0,0,NPC
BRD-K03608458_10uM_24h,BRD-K03608458,10 uM,24 h,4,56,60,2,3,2,1,NPC
bongkrek-acid_10uM_24h,bongkrek-acid,10 uM,24 h,4,37,41,1,0,0,0,NPC
irilin-a_10uM_24h,irilin-a,10 uM,24 h,4,40,44,1,0,0,0,NPC
BRD-A32582647_10uM_6h,BRD-A32582647,10 uM,6 h,4,44,48,2,0,0,0,NPC
L-741626_10uM_24h,L-741626,10 uM,24 h,4,40,44,1,1,1,0,NPC
umbelliferone_10uM_24h,umbelliferone,10 uM,24 h,4,40,44,1,0,0,0,NPC
fraxidin_10uM_24h,fraxidin,10 uM,24 h,4,39,43,1,4,2,2,NPC
CDC_10uM_24h,CDC,10 uM,24 h,4,39,43,1,133,33,100,NPC
TYRPHOSTIN-46_10uM_24h,TYRPHOSTIN-46,10 uM,24 h,4,39,43,1,5,4,1,NPC
BRD-K72783841_10uM_24h,BRD-K72783841,10 uM,24 h,4,40,44,1,5,2,3,NPC
BRD-A49906757_10uM_24h,BRD-A49906757,10 uM,24 h,4,39,43,1,0,0,0,NPC
BRD-K16604360_10uM_24h,BRD-K16604360,10 uM,24 h,4,40,44,1,1,1,0,NPC
mead-ethanolamide_10uM_24h,mead-ethanolamide,10 uM,24 h,4,39,43,1,0,0,0,NPC
mocimycin_10uM_24h,mocimycin,10 uM,24 h,4,39,43,1,13,4,9,NPC
SC-68376_10uM_24h,SC-68376,10 uM,24 h,4,40,44,1,0,0,0,NPC
rhizocarpic-acid_10uM_24h,rhizocarpic-acid,10 uM,24 h,4,37,41,1,0,0,0,NPC
leucodin_10uM_24h,leucodin,10 uM,24 h,4,39,43,1,1,0,1,NPC
ergocornine_10uM_24h,ergocornine,10 uM,24 h,4,40,44,1,0,0,0,NPC
BRD-A24951056_10uM_24h,BRD-A24951056,10 uM,24 h,4,50,54,2,0,0,0,NPC
JS-K_10uM_24h,JS-K,10 uM,24 h,4,40,44,2,248,88,160,NPC
BRD-K36614862_0.04uM_24h,BRD-K36614862,0.04 uM,24 h,4,40,44,1,1,0,1,NPC
BRD-K36614862_1.11uM_24h,BRD-K36614862,1.11 uM,24 h,4,40,44,1,2,1,1,NPC
BRD-K36614862_3.33uM_24h,BRD-K36614862,3.33 uM,24 h,4,40,44,1,8,5,3,NPC
BRD-K60636255_10uM_24h,BRD-K60636255,10 uM,24 h,3,45,48,1,18,10,8,NPC
BRD-K43357772_10uM_24h,BRD-K43357772,10 uM,24 h,3,54,57,1,10,5,5,NPC
BRD-K24698610_10uM_24h,BRD-K24698610,10 uM,24 h,3,45,48,1,4,2,2,NPC
BRD-K20109053_10uM_24h,BRD-K20109053,10 uM,24 h,3,54,57,1,17,14,3,NPC
BRD-K31931379_10uM_24h,BRD-K31931379,10 uM,24 h,3,45,48,1,4,3,1,NPC
BRD-K90734091_10uM_24h,BRD-K90734091,10 uM,24 h,3,45,48,1,17,9,8,NPC
BRD-K08443710_10uM_24h,BRD-K08443710,10 uM,24 h,3,54,57,1,0,0,0,NPC
BRD-K32885145_10uM_24h,BRD-K32885145,10 uM,24 h,3,45,48,1,50,23,27,NPC
BRD-K42743267_10uM_24h,BRD-K42743267,10 uM,24 h,3,45,48,1,3,3,0,NPC
BRD-K05353139_10uM_24h,BRD-K05353139,10 uM,24 h,3,54,57,1,6,4,2,NPC
BRD-K43540029_10uM_24h,BRD-K43540029,10 uM,24 h,3,54,57,1,4,1,3,NPC
BRD-K44410738_10uM_24h,BRD-K44410738,10 uM,24 h,3,45,48,1,24,12,12,NPC
BRD-K26484692_10uM_24h,BRD-K26484692,10 uM,24 h,3,45,48,1,294,137,157,NPC
BRD-K63423329_10uM_24h,BRD-K63423329,10 uM,24 h,3,54,57,1,6,3,3,NPC
BRD-K03957451_10uM_24h,BRD-K03957451,10 uM,24 h,3,54,57,1,2,1,1,NPC
BRD-K30229575_10uM_24h,BRD-K30229575,10 uM,24 h,3,45,48,1,184,82,102,NPC
BRD-K61102260_10uM_24h,BRD-K61102260,10 uM,24 h,3,45,48,1,80,24,56,NPC
BRD-K20352452_10uM_24h,BRD-K20352452,10 uM,24 h,3,45,48,1,18,12,6,NPC
BRD-K81408913_10uM_24h,BRD-K81408913,10 uM,24 h,3,54,57,1,107,48,59,NPC
BRD-K41129365_10uM_24h,BRD-K41129365,10 uM,24 h,3,54,57,1,8,3,5,NPC
BRD-K08293924_10uM_24h,BRD-K08293924,10 uM,24 h,3,45,48,1,6,4,2,NPC
BRD-K00141503_10uM_24h,BRD-K00141503,10 uM,24 h,3,45,48,1,129,54,75,NPC
BRD-A74699940_10uM_24h,BRD-A74699940,10 uM,24 h,3,27,30,1,18,8,10,NPC
ellipticine_10uM_24h,ellipticine,10 uM,24 h,3,29,32,1,3,3,0,NPC
BRD-K48716658_10uM_24h,BRD-K48716658,10 uM,24 h,3,27,30,1,127,49,78,NPC
BRD-K92863101_10uM_24h,BRD-K92863101,10 uM,24 h,3,29,32,1,31,4,27,NPC
BRD-K38012662_10uM_24h,BRD-K38012662,10 uM,24 h,3,29,32,1,52,24,28,NPC
BRD-A13367427_10uM_24h,BRD-A13367427,10 uM,24 h,3,29,32,1,15,1,14,NPC
BRD-A76732176_10uM_24h,BRD-A76732176,10 uM,24 h,3,29,32,1,2,1,1,NPC
HC-toxin_10uM_24h,HC-toxin,10 uM,24 h,3,29,32,1,16,7,9,NPC
BRD-K30511626_10uM_24h,BRD-K30511626,10 uM,24 h,3,27,30,1,37,6,31,NPC
ST-209453_10uM_24h,ST-209453,10 uM,24 h,3,27,30,1,106,53,53,NPC
BRD-A09984573_10uM_24h,BRD-A09984573,10 uM,24 h,3,27,30,1,17,2,15,NPC
BRD-K22630935_10uM_24h,BRD-K22630935,10 uM,24 h,3,29,32,1,7,4,3,NPC
BRD-K93296644_10uM_24h,BRD-K93296644,10 uM,24 h,3,27,30,1,227,103,124,NPC
BRD-K28115298_10uM_24h,BRD-K28115298,10 uM,24 h,3,27,30,1,2,2,0,NPC
I-070759_10uM_24h,I-070759,10 uM,24 h,3,27,30,1,0,0,0,NPC
BRD-K28680267_10uM_24h,BRD-K28680267,10 uM,24 h,3,32,35,1,0,0,0,NPC
BRD-K81313552_10uM_24h,BRD-K81313552,10 uM,24 h,3,29,32,1,0,0,0,NPC
KM-04501_10uM_24h,KM-04501,10 uM,24 h,3,29,32,1,1,0,1,NPC
BRD-K93899689_10uM_24h,BRD-K93899689,10 uM,24 h,3,27,30,1,3,1,2,NPC
harpagoside_10uM_24h,harpagoside,10 uM,24 h,3,25,28,1,0,0,0,NPC
BRD-A12643502_10uM_24h,BRD-A12643502,10 uM,24 h,3,27,30,1,8,1,7,NPC
BRD-K69516039_10uM_24h,BRD-K69516039,10 uM,24 h,3,29,32,1,1,0,1,NPC
BRD-K80346834_10uM_24h,BRD-K80346834,10 uM,24 h,3,27,30,1,4,3,1,NPC
BRD-K41931739_10uM_24h,BRD-K41931739,10 uM,24 h,3,27,30,1,2,1,1,NPC
BRD-U29336476_10uM_24h,BRD-U29336476,10 uM,24 h,3,29,32,1,9,0,9,NPC
BRD-K48296029_10uM_24h,BRD-K48296029,10 uM,24 h,3,54,57,1,3,1,2,NPC
BRD-K54051742_10uM_24h,BRD-K54051742,10 uM,24 h,3,45,48,1,94,27,67,NPC
BRD-K85650383_10uM_24h,BRD-K85650383,10 uM,24 h,3,54,57,1,0,0,0,NPC
BRD-K80058284_10uM_24h,BRD-K80058284,10 uM,24 h,3,45,48,1,10,3,7,NPC
BRD-K75264577_10uM_24h,BRD-K75264577,10 uM,24 h,3,54,57,1,2,1,1,NPC
BRD-K58808184_10uM_24h,BRD-K58808184,10 uM,24 h,3,54,57,1,0,0,0,NPC
BRD-K05778745_10uM_24h,BRD-K05778745,10 uM,24 h,3,54,57,1,2,1,1,NPC
BRD-K09526594_10uM_24h,BRD-K09526594,10 uM,24 h,3,45,48,1,87,28,59,NPC
BRD-K81658952_10uM_24h,BRD-K81658952,10 uM,24 h,3,45,48,1,16,7,9,NPC
BRD-K42694358_10uM_24h,BRD-K42694358,10 uM,24 h,3,45,48,1,19,9,10,NPC
BRD-K40274786_10uM_24h,BRD-K40274786,10 uM,24 h,3,54,57,1,1,1,0,NPC
BRD-K37650321_10uM_24h,BRD-K37650321,10 uM,24 h,3,45,48,1,91,50,41,NPC
BRD-K68504618_10uM_24h,BRD-K68504618,10 uM,24 h,3,54,57,1,12,4,8,NPC
BRD-K50277523_10uM_24h,BRD-K50277523,10 uM,24 h,3,45,48,1,6,3,3,NPC
BRD-K40471863_10uM_24h,BRD-K40471863,10 uM,24 h,3,45,48,1,2,1,1,NPC
BRD-K28841686_10uM_24h,BRD-K28841686,10 uM,24 h,3,54,57,1,10,4,6,NPC
BRD-K01981286_10uM_24h,BRD-K01981286,10 uM,24 h,3,54,57,1,10,5,5,NPC
BRD-K49477330_10uM_24h,BRD-K49477330,10 uM,24 h,3,54,57,1,117,54,63,NPC
BRD-K19198293_10uM_24h,BRD-K19198293,10 uM,24 h,3,54,57,1,8,3,5,NPC
BRD-K48576794_10uM_24h,BRD-K48576794,10 uM,24 h,3,29,32,1,7,6,1,NPC
BRD-K38519699_10uM_24h,BRD-K38519699,10 uM,24 h,3,29,32,1,6,0,6,NPC
BRD-K21165668_10uM_24h,BRD-K21165668,10 uM,24 h,3,29,32,1,18,8,10,NPC
BRD-K69496360_10uM_24h,BRD-K69496360,10 uM,24 h,3,29,32,1,1,1,0,NPC
BRD-K65342895_10uM_24h,BRD-K65342895,10 uM,24 h,3,27,30,1,5,3,2,NPC
BRD-K54405293_10uM_24h,BRD-K54405293,10 uM,24 h,3,27,30,1,7,2,5,NPC
BRD-K05672354_10uM_24h,BRD-K05672354,10 uM,24 h,3,27,30,1,8,3,5,NPC
BRD-K16541732_10uM_24h,BRD-K16541732,10 uM,24 h,3,27,30,1,219,95,124,NPC
sinensetin_10uM_24h,sinensetin,10 uM,24 h,3,32,35,1,1,1,0,NPC
BRD-K96403486_10uM_24h,BRD-K96403486,10 uM,24 h,3,29,32,1,0,0,0,NPC
dexketoprofen_10uM_24h,dexketoprofen,10 uM,24 h,3,29,32,1,38,18,20,NPC
BRD-K32188552_10uM_24h,BRD-K32188552,10 uM,24 h,3,32,35,1,0,0,0,NPC
BRD-K58141791_10uM_24h,BRD-K58141791,10 uM,24 h,3,27,30,1,1,0,1,NPC
proscillaridin_10uM_24h,proscillaridin,10 uM,24 h,3,29,32,1,475,189,286,NPC
BRD-K70960308_10uM_24h,BRD-K70960308,10 uM,24 h,3,29,32,1,1,1,0,NPC
L-803087_10uM_24h,L-803087,10 uM,24 h,3,25,28,1,0,0,0,NPC
BRD-K59460069_10uM_24h,BRD-K59460069,10 uM,24 h,3,27,30,1,7,1,6,NPC
BRD-K88964386_10uM_24h,BRD-K88964386,10 uM,24 h,3,29,32,1,0,0,0,NPC
bulleyaconitine-a_10uM_24h,bulleyaconitine-a,10 uM,24 h,3,32,35,1,0,0,0,NPC
BRD-K89961851_10uM_24h,BRD-K89961851,10 uM,24 h,3,45,48,1,24,12,12,NPC
BRD-K37060179_10uM_24h,BRD-K37060179,10 uM,24 h,3,45,48,1,12,5,7,NPC
BRD-K30066603_10uM_24h,BRD-K30066603,10 uM,24 h,3,45,48,1,27,9,18,NPC
BRD-K94616516_10uM_24h,BRD-K94616516,10 uM,24 h,3,45,48,1,12,4,8,NPC
BRD-K31829694_10uM_24h,BRD-K31829694,10 uM,24 h,3,45,48,1,67,23,44,NPC
BRD-K63813530_10uM_24h,BRD-K63813530,10 uM,24 h,3,45,48,1,30,11,19,NPC
BRD-K06188347_10uM_24h,BRD-K06188347,10 uM,24 h,3,45,48,1,9,6,3,NPC
BRD-K51810646_10uM_24h,BRD-K51810646,10 uM,24 h,3,45,48,1,57,19,38,NPC
BRD-K95582125_10uM_24h,BRD-K95582125,10 uM,24 h,3,54,57,1,2,1,1,NPC
BRD-K63923428_10uM_24h,BRD-K63923428,10 uM,24 h,3,45,48,1,70,24,46,NPC
BRD-K85236313_10uM_24h,BRD-K85236313,10 uM,24 h,3,54,57,1,3,1,2,NPC
BRD-K14095788_10uM_24h,BRD-K14095788,10 uM,24 h,3,45,48,1,49,23,26,NPC
BRD-K25379780_10uM_24h,BRD-K25379780,10 uM,24 h,3,54,57,1,3,1,2,NPC
BRD-K65085267_10uM_24h,BRD-K65085267,10 uM,24 h,3,45,48,1,4,2,2,NPC
BRD-K29423519_10uM_24h,BRD-K29423519,10 uM,24 h,3,54,57,1,97,29,68,NPC
BRD-K45230579_10uM_24h,BRD-K45230579,10 uM,24 h,3,45,48,1,236,48,188,NPC
BRD-K54925167_10uM_24h,BRD-K54925167,10 uM,24 h,3,54,57,1,1,0,1,NPC
BRD-K95367721_10uM_24h,BRD-K95367721,10 uM,24 h,3,45,48,1,13,5,8,NPC
BRD-K23872111_10uM_24h,BRD-K23872111,10 uM,24 h,3,54,57,1,0,0,0,NPC
BRD-K87790979_10uM_24h,BRD-K87790979,10 uM,24 h,3,45,48,1,33,15,18,NPC
BRD-K19011062_10uM_24h,BRD-K19011062,10 uM,24 h,3,45,48,1,10,6,4,NPC
BRD-K52831896_10uM_24h,BRD-K52831896,10 uM,24 h,3,29,32,1,1,1,0,NPC
QW-BI-011_10uM_24h,QW-BI-011,10 uM,24 h,3,29,32,1,1,1,0,NPC
BRD-K98634983_10uM_24h,BRD-K98634983,10 uM,24 h,3,27,30,1,10,6,4,NPC
BRD-A25416824_10uM_24h,BRD-A25416824,10 uM,24 h,3,27,30,1,25,5,20,NPC
BRD-K37932103_10uM_24h,BRD-K37932103,10 uM,24 h,3,27,30,1,0,0,0,NPC
BRD-K83355732_10uM_24h,BRD-K83355732,10 uM,24 h,3,29,32,1,34,26,8,NPC
CAY-10470_10uM_24h,CAY-10470,10 uM,24 h,3,29,32,1,14,11,3,NPC
SEW-05685_10uM_24h,SEW-05685,10 uM,24 h,3,27,30,1,1,0,1,NPC
ARG-CSC2-23_10uM_24h,ARG-CSC2-23,10 uM,24 h,3,29,32,1,0,0,0,NPC
BRD-K51608872_10uM_24h,BRD-K51608872,10 uM,24 h,3,27,30,1,64,30,34,NPC
BRD-A59145032_10uM_24h,BRD-A59145032,10 uM,24 h,3,29,32,1,109,36,73,NPC
BRD-A81530502_10uM_24h,BRD-A81530502,10 uM,24 h,3,27,30,1,3,2,1,NPC
CAY-10415_10uM_24h,CAY-10415,10 uM,24 h,3,29,32,1,0,0,0,NPC
BRD-K42419294_10uM_24h,BRD-K42419294,10 uM,24 h,3,29,32,1,7,4,3,NPC
biochanin-a_10uM_24h,biochanin-a,10 uM,24 h,3,30,33,1,6,3,3,NPC
BRD-A49581300_10uM_24h,BRD-A49581300,10 uM,24 h,3,27,30,1,0,0,0,NPC
BRD-K14316227_10uM_24h,BRD-K14316227,10 uM,24 h,3,29,32,1,5,5,0,NPC
BRD-K58784778_10uM_24h,BRD-K58784778,10 uM,24 h,3,27,30,1,1,0,1,NPC
BRD-K19166598_10uM_24h,BRD-K19166598,10 uM,24 h,3,27,30,1,3,1,2,NPC
BRD-K89558221_10uM_24h,BRD-K89558221,10 uM,24 h,3,27,30,1,5,2,3,NPC
BRD-K84114569_10uM_24h,BRD-K84114569,10 uM,24 h,3,29,32,1,7,3,4,NPC
BRD-K55612480_10uM_24h,BRD-K55612480,10 uM,24 h,3,27,30,1,21,7,14,NPC
BRD-K08799950_10uM_24h,BRD-K08799950,10 uM,24 h,3,27,30,1,0,0,0,NPC
BRD-K02701279_10uM_24h,BRD-K02701279,10 uM,24 h,3,29,32,1,0,0,0,NPC
solanine_10uM_24h,solanine,10 uM,24 h,3,32,35,1,1,1,0,NPC
BRD-A36165599_10uM_24h,BRD-A36165599,10 uM,24 h,3,29,32,1,0,0,0,NPC
SA-425500_10uM_24h,SA-425500,10 uM,24 h,3,27,30,1,6,3,3,NPC
MW-STK33-22_10uM_24h,MW-STK33-22,10 uM,24 h,3,27,30,1,0,0,0,NPC
BRD-K30381304_10uM_24h,BRD-K30381304,10 uM,24 h,3,29,32,1,0,0,0,NPC
BRD-K57420195_10uM_24h,BRD-K57420195,10 uM,24 h,3,54,57,1,14,2,12,NPC
BRD-K44635753_10uM_24h,BRD-K44635753,10 uM,24 h,3,45,48,1,25,17,8,NPC
BRD-K07244661_10uM_24h,BRD-K07244661,10 uM,24 h,3,45,48,1,1,1,0,NPC
BRD-K77793090_10uM_24h,BRD-K77793090,10 uM,24 h,3,54,57,1,1,1,0,NPC
BRD-K66658536_10uM_24h,BRD-K66658536,10 uM,24 h,3,54,57,1,12,6,6,NPC
BRD-K22912836_10uM_24h,BRD-K22912836,10 uM,24 h,3,54,57,1,8,4,4,NPC
SA-419083_10uM_24h,SA-419083,10 uM,24 h,3,54,57,1,2,1,1,NPC
SA-424828_10uM_24h,SA-424828,10 uM,24 h,3,45,48,1,4,3,1,NPC
BRD-K63164430_10uM_24h,BRD-K63164430,10 uM,24 h,3,45,48,1,31,15,16,NPC
BRD-K96477379_10uM_24h,BRD-K96477379,10 uM,24 h,3,45,48,1,17,8,9,NPC
BRD-K21374126_10uM_24h,BRD-K21374126,10 uM,24 h,3,54,57,1,1,1,0,NPC
BRD-K47512679_10uM_24h,BRD-K47512679,10 uM,24 h,3,45,48,1,23,16,7,NPC
SA-90377_10uM_24h,SA-90377,10 uM,24 h,3,45,48,1,37,16,21,NPC
SA-1921867_10uM_24h,SA-1921867,10 uM,24 h,3,54,57,1,1,0,1,NPC
BRD-K68190084_10uM_24h,BRD-K68190084,10 uM,24 h,3,45,48,1,12,6,6,NPC
BRD-K52006320_10uM_24h,BRD-K52006320,10 uM,24 h,3,54,57,1,6,3,3,NPC
BRD-K46232974_10uM_24h,BRD-K46232974,10 uM,24 h,3,54,57,1,0,0,0,NPC
BRD-K98437249_10uM_24h,BRD-K98437249,10 uM,24 h,3,54,57,1,0,0,0,NPC
BRD-K08713111_10uM_6h,BRD-K08713111,10 uM,6 h,3,34,37,2,88,29,59,NPC
MRS-1754_10uM_24h,MRS-1754,10 uM,24 h,3,26,29,1,22,8,14,NPC
BAS-02859604_10uM_24h,BAS-02859604,10 uM,24 h,3,29,32,1,0,0,0,NPC
BRD-A84102390_10uM_24h,BRD-A84102390,10 uM,24 h,3,27,30,1,0,0,0,NPC
BRD-K04188046_10uM_24h,BRD-K04188046,10 uM,24 h,3,29,32,1,0,0,0,NPC
ST-4049616_10uM_24h,ST-4049616,10 uM,24 h,3,27,30,1,0,0,0,NPC
BRD-K98064019_10uM_24h,BRD-K98064019,10 uM,24 h,3,29,32,1,37,7,30,NPC
BRD-K13544237_10uM_24h,BRD-K13544237,10 uM,24 h,3,32,35,1,0,0,0,NPC
hemado_10uM_24h,hemado,10 uM,24 h,3,31,34,1,3,1,2,NPC
BRD-A57300602_10uM_24h,BRD-A57300602,10 uM,24 h,3,27,30,1,0,0,0,NPC
BRD-A72837804_10uM_24h,BRD-A72837804,10 uM,24 h,3,29,32,1,0,0,0,NPC
BRD-K69003436_10uM_24h,BRD-K69003436,10 uM,24 h,3,29,32,1,5,0,5,NPC
BRD-K94493764_10uM_24h,BRD-K94493764,10 uM,24 h,3,27,30,1,170,76,94,NPC
BRD-K11778372_10uM_24h,BRD-K11778372,10 uM,24 h,3,27,30,1,0,0,0,NPC
STK-222600_10uM_24h,STK-222600,10 uM,24 h,3,29,32,1,82,12,70,NPC
BRD-K86901264_10uM_24h,BRD-K86901264,10 uM,24 h,3,27,30,1,60,26,34,NPC
BRD-U64289953_10uM_24h,BRD-U64289953,10 uM,24 h,3,29,32,1,11,5,6,NPC
BRD-K18364651_10uM_24h,BRD-K18364651,10 uM,24 h,3,27,30,1,3,2,1,NPC
BRD-K84571636_10uM_24h,BRD-K84571636,10 uM,24 h,3,27,30,1,1,1,0,NPC
BRD-K51683034_10uM_24h,BRD-K51683034,10 uM,24 h,3,27,30,1,103,22,81,NPC
BRD-K12621773_10uM_24h,BRD-K12621773,10 uM,24 h,3,29,32,1,19,2,17,NPC
BRD-A22272113_10uM_24h,BRD-A22272113,10 uM,24 h,3,29,32,1,2,0,2,NPC
BRD-K00551481_10uM_24h,BRD-K00551481,10 uM,24 h,3,29,32,1,0,0,0,NPC
BRD-K44812652_10uM_24h,BRD-K44812652,10 uM,24 h,3,27,30,1,2,0,2,NPC
BRD-K61175124_10uM_24h,BRD-K61175124,10 uM,24 h,3,27,30,1,25,10,15,NPC
BRD-A49447682_10uM_24h,BRD-A49447682,10 uM,24 h,3,29,32,1,24,7,17,NPC
BRD-K88556033_10uM_24h,BRD-K88556033,10 uM,24 h,3,29,32,1,23,4,19,NPC
BRD-K62242359_10uM_24h,BRD-K62242359,10 uM,24 h,3,45,48,1,336,137,199,NPC
BRD-K50131741_10uM_24h,BRD-K50131741,10 uM,24 h,3,54,57,1,1,0,1,NPC
BRD-K16769902_10uM_24h,BRD-K16769902,10 uM,24 h,3,45,48,1,14,7,7,NPC
BRD-K08251038_10uM_24h,BRD-K08251038,10 uM,24 h,3,54,57,1,9,5,4,NPC
BRD-K48598367_10uM_24h,BRD-K48598367,10 uM,24 h,3,54,57,1,11,5,6,NPC
SA-424763_10uM_24h,SA-424763,10 uM,24 h,3,54,57,1,0,0,0,NPC
BRD-K69218883_10uM_24h,BRD-K69218883,10 uM,24 h,3,45,48,1,15,9,6,NPC
BRD-K33452357_10uM_24h,BRD-K33452357,10 uM,24 h,3,45,48,1,28,14,14,NPC
BRD-K01048110_10uM_24h,BRD-K01048110,10 uM,24 h,3,54,57,1,1,1,0,NPC
BRD-K75035820_10uM_24h,BRD-K75035820,10 uM,24 h,3,45,48,1,39,16,23,NPC
BRD-K83072410_10uM_24h,BRD-K83072410,10 uM,24 h,3,45,48,1,31,14,17,NPC
BRD-K40276799_10uM_24h,BRD-K40276799,10 uM,24 h,3,45,48,1,108,32,76,NPC
BRD-K97633445_10uM_24h,BRD-K97633445,10 uM,24 h,3,45,48,1,77,34,43,NPC
BRD-K24106654_10uM_24h,BRD-K24106654,10 uM,24 h,3,45,48,1,9,2,7,NPC
buddleoflavonoloside_10uM_24h,buddleoflavonoloside,10 uM,24 h,3,32,35,1,0,0,0,NPC
BRD-K76938712_10uM_24h,BRD-K76938712,10 uM,24 h,3,27,30,1,0,0,0,NPC
BRD-K63549648_10uM_24h,BRD-K63549648,10 uM,24 h,3,27,30,1,4,1,3,NPC
BRD-K58972465_10uM_24h,BRD-K58972465,10 uM,24 h,3,29,32,1,31,1,30,NPC
XL-147_10uM_24h,XL-147,10 uM,24 h,3,29,32,1,20,8,12,NPC
BRD-K76926998_10uM_24h,BRD-K76926998,10 uM,24 h,3,29,32,1,1,0,1,NPC
BRD-K22322324_10uM_24h,BRD-K22322324,10 uM,24 h,3,27,30,1,12,6,6,NPC
BRD-K41303952_10uM_24h,BRD-K41303952,10 uM,24 h,3,27,30,1,46,16,30,NPC
BRD-K55630727_10uM_24h,BRD-K55630727,10 uM,24 h,3,29,32,1,2,0,2,NPC
BRD-K14844937_10uM_24h,BRD-K14844937,10 uM,24 h,3,32,35,1,1,0,1,NPC
BRD-A06131576_10uM_24h,BRD-A06131576,10 uM,24 h,3,29,32,1,2,1,1,NPC
LY-16350_10uM_24h,LY-16350,10 uM,24 h,3,32,35,1,0,0,0,NPC
BRD-K93215584_10uM_24h,BRD-K93215584,10 uM,24 h,3,27,30,1,49,14,35,NPC
BRD-K97149069_10uM_24h,BRD-K97149069,10 uM,24 h,3,29,32,1,2,0,2,NPC
BRD-K21788104_10uM_24h,BRD-K21788104,10 uM,24 h,3,29,32,1,15,9,6,NPC
l-bso_10uM_24h,l-bso,10 uM,24 h,3,27,30,1,156,60,96,NPC
BRD-A41114263_10uM_24h,BRD-A41114263,10 uM,24 h,3,27,30,1,0,0,0,NPC
BRD-K26373640_10uM_24h,BRD-K26373640,10 uM,24 h,3,32,35,1,0,0,0,NPC
BRD-K55996963_10uM_24h,BRD-K55996963,10 uM,24 h,3,29,32,1,17,1,16,NPC
BRD-K66426634_10uM_24h,BRD-K66426634,10 uM,24 h,3,29,32,1,29,6,23,NPC
BRD-K53816294_10uM_24h,BRD-K53816294,10 uM,24 h,3,29,32,1,159,30,129,NPC
BRD-A67306036_10uM_24h,BRD-A67306036,10 uM,24 h,3,29,32,1,0,0,0,NPC
BRD-K19181733_10uM_24h,BRD-K19181733,10 uM,24 h,3,27,30,1,28,7,21,NPC
BRD-K47709646_10uM_24h,BRD-K47709646,10 uM,24 h,3,29,32,1,69,18,51,NPC
BRD-K47703442_10uM_24h,BRD-K47703442,10 uM,24 h,3,29,32,1,1,0,1,NPC
BRD-K97951054_10uM_24h,BRD-K97951054,10 uM,24 h,3,29,32,1,1,0,1,NPC
BRD-K39284479_10uM_24h,BRD-K39284479,10 uM,24 h,3,45,48,1,32,15,17,NPC
BRD-K31290914_10uM_24h,BRD-K31290914,10 uM,24 h,3,45,48,1,24,10,14,NPC
BRD-K96551169_10uM_24h,BRD-K96551169,10 uM,24 h,3,45,48,1,8,4,4,NPC
BRD-K20310932_10uM_24h,BRD-K20310932,10 uM,24 h,3,54,57,1,1,0,1,NPC
BRD-K41862560_10uM_24h,BRD-K41862560,10 uM,24 h,3,54,57,1,0,0,0,NPC
BRD-K11088254_10uM_24h,BRD-K11088254,10 uM,24 h,3,54,57,1,0,0,0,NPC
BRD-K86149906_10uM_24h,BRD-K86149906,10 uM,24 h,3,54,57,1,0,0,0,NPC
BRD-K76418961_10uM_24h,BRD-K76418961,10 uM,24 h,3,45,48,1,104,26,78,NPC
BRD-K95047050_10uM_24h,BRD-K95047050,10 uM,24 h,3,45,48,1,10,8,2,NPC
BRD-K69760878_10uM_24h,BRD-K69760878,10 uM,24 h,3,54,57,1,13,7,6,NPC
BRD-K68253248_10uM_24h,BRD-K68253248,10 uM,24 h,3,45,48,1,19,10,9,NPC
BRD-K61001510_10uM_24h,BRD-K61001510,10 uM,24 h,3,54,57,1,81,36,45,NPC
BRD-K63828515_10uM_24h,BRD-K63828515,10 uM,24 h,3,45,48,1,99,26,73,NPC
BRD-K37303684_10uM_24h,BRD-K37303684,10 uM,24 h,3,45,48,1,5,2,3,NPC
BRD-K80439608_10uM_24h,BRD-K80439608,10 uM,24 h,3,45,48,1,95,35,60,NPC
BRD-K93116089_10uM_24h,BRD-K93116089,10 uM,24 h,3,45,48,1,68,18,50,NPC
BRD-K09068728_10uM_24h,BRD-K09068728,10 uM,24 h,3,45,48,1,10,7,3,NPC
niguldipine_10uM_24h,niguldipine,10 uM,24 h,3,31,34,1,34,9,25,NPC
BRD-K00944562_10uM_24h,BRD-K00944562,10 uM,24 h,3,29,32,1,5,4,1,NPC
BRD-A89907244_10uM_24h,BRD-A89907244,10 uM,24 h,3,29,32,1,0,0,0,NPC
D-609_10uM_24h,D-609,10 uM,24 h,3,29,32,1,3,1,2,NPC
BRD-K56392985_10uM_24h,BRD-K56392985,10 uM,24 h,3,29,32,1,0,0,0,NPC
BRD-K90849765_10uM_24h,BRD-K90849765,10 uM,24 h,3,29,32,1,2,0,2,NPC
BRD-K75458636_10uM_24h,BRD-K75458636,10 uM,24 h,3,29,32,1,1,0,1,NPC
bufalin_10uM_24h,bufalin,10 uM,24 h,3,32,35,1,384,167,217,NPC
BRD-K01800709_10uM_24h,BRD-K01800709,10 uM,24 h,3,29,32,1,32,10,22,NPC
LE-300_10uM_24h,LE-300,10 uM,24 h,3,32,35,1,4,4,0,NPC
CP-466722_10uM_24h,CP-466722,10 uM,24 h,3,27,30,1,12,5,7,NPC
BRD-A01317026_10uM_24h,BRD-A01317026,10 uM,24 h,3,29,32,1,1,0,1,NPC
SA-1457187_10uM_24h,SA-1457187,10 uM,24 h,3,45,48,1,40,24,16,NPC
BRD-K97318829_10uM_24h,BRD-K97318829,10 uM,24 h,3,54,57,1,1,0,1,NPC
BRD-K70669970_10uM_24h,BRD-K70669970,10 uM,24 h,3,45,48,1,23,10,13,NPC
BRD-K51595563_10uM_24h,BRD-K51595563,10 uM,24 h,3,45,48,1,123,35,88,NPC
BRD-K90281509_10uM_24h,BRD-K90281509,10 uM,24 h,3,45,48,1,21,3,18,NPC
BRD-K37879871_10uM_24h,BRD-K37879871,10 uM,24 h,3,54,57,1,2,1,1,NPC
BRD-K54294645_10uM_24h,BRD-K54294645,10 uM,24 h,3,54,57,1,2,1,1,NPC
BRD-K51633576_10uM_24h,BRD-K51633576,10 uM,24 h,3,45,48,1,6,1,5,NPC
BRD-K43776433_10uM_24h,BRD-K43776433,10 uM,24 h,3,54,57,1,1,0,1,NPC
BRD-K39597586_10uM_24h,BRD-K39597586,10 uM,24 h,3,45,48,1,76,53,23,NPC
BRD-K23958338_10uM_24h,BRD-K23958338,10 uM,24 h,3,54,57,1,1,0,1,NPC
BRD-K31112909_10uM_24h,BRD-K31112909,10 uM,24 h,3,54,57,1,7,3,4,NPC
BRD-K25164076_10uM_24h,BRD-K25164076,10 uM,24 h,3,45,48,1,45,25,20,NPC
BRD-K44732214_10uM_24h,BRD-K44732214,10 uM,24 h,3,54,57,1,22,16,6,NPC
BRD-K87340398_10uM_24h,BRD-K87340398,10 uM,24 h,3,45,48,1,20,5,15,NPC
BRD-K75813018_10uM_24h,BRD-K75813018,10 uM,24 h,3,45,48,1,0,0,0,NPC
BRD-K54247306_10uM_24h,BRD-K54247306,10 uM,24 h,3,45,48,1,38,13,25,NPC
BRD-K93610587_10uM_24h,BRD-K93610587,10 uM,24 h,3,45,48,1,17,8,9,NPC
BRD-K33586157_10uM_24h,BRD-K33586157,10 uM,24 h,3,29,32,1,0,0,0,NPC
BRD-K08115555_10uM_24h,BRD-K08115555,10 uM,24 h,3,29,32,1,53,14,39,NPC
BRD-A52771319_10uM_24h,BRD-A52771319,10 uM,24 h,3,32,35,1,0,0,0,NPC
BRD-K09997269_10uM_24h,BRD-K09997269,10 uM,24 h,3,29,32,1,0,0,0,NPC
ST-4034917_10uM_24h,ST-4034917,10 uM,24 h,3,27,30,1,6,2,4,NPC
MW-A1-14_10uM_24h,MW-A1-14,10 uM,24 h,3,29,32,1,1,1,0,NPC
BRD-K30993697_10uM_24h,BRD-K30993697,10 uM,24 h,3,29,32,1,152,41,111,NPC
BRD-K32927008_10uM_24h,BRD-K32927008,10 uM,24 h,3,29,32,1,10,7,3,NPC
BRD-A36884011_10uM_24h,BRD-A36884011,10 uM,24 h,3,29,32,1,0,0,0,NPC
BRD-A26962727_10uM_24h,BRD-A26962727,10 uM,24 h,3,29,32,1,0,0,0,NPC
SA-1457472_10uM_24h,SA-1457472,10 uM,24 h,3,45,48,1,278,94,184,NPC
BRD-K90424352_10uM_24h,BRD-K90424352,10 uM,24 h,3,54,57,1,3,2,1,NPC
BRD-K48724570_10uM_24h,BRD-K48724570,10 uM,24 h,3,54,57,1,5,2,3,NPC
BRD-K39151515_10uM_24h,BRD-K39151515,10 uM,24 h,3,54,57,1,8,5,3,NPC
BRD-K24798550_10uM_24h,BRD-K24798550,10 uM,24 h,3,45,48,1,56,28,28,NPC
BRD-K74043769_10uM_24h,BRD-K74043769,10 uM,24 h,3,45,48,1,3,1,2,NPC
BRD-K53808186_10uM_24h,BRD-K53808186,10 uM,24 h,3,45,48,1,13,9,4,NPC
BRD-K00381581_10uM_24h,BRD-K00381581,10 uM,24 h,3,45,48,1,28,10,18,NPC
BRD-K07907451_10uM_24h,BRD-K07907451,10 uM,24 h,3,45,48,1,189,72,117,NPC
BRD-K40225343_10uM_24h,BRD-K40225343,10 uM,24 h,3,54,57,1,9,5,4,NPC
BRD-K03006541_10uM_24h,BRD-K03006541,10 uM,24 h,3,45,48,1,13,7,6,NPC
BRD-K88373420_10uM_24h,BRD-K88373420,10 uM,24 h,3,54,57,1,0,0,0,NPC
BRD-K16714380_10uM_24h,BRD-K16714380,10 uM,24 h,3,54,57,1,9,6,3,NPC
BRD-K91946056_10uM_24h,BRD-K91946056,10 uM,24 h,3,54,57,1,2,1,1,NPC
BRD-K09459434_10uM_24h,BRD-K09459434,10 uM,24 h,3,54,57,1,0,0,0,NPC
BRD-K10906552_10uM_24h,BRD-K10906552,10 uM,24 h,3,29,32,1,93,39,54,NPC
BRD-K64058329_10uM_24h,BRD-K64058329,10 uM,24 h,3,29,32,1,0,0,0,NPC
BRD-K24346336_10uM_24h,BRD-K24346336,10 uM,24 h,3,27,30,1,53,14,39,NPC
BRD-K78062244_10uM_24h,BRD-K78062244,10 uM,24 h,3,29,32,1,190,75,115,NPC
BRD-A80383043_10uM_24h,BRD-A80383043,10 uM,24 h,3,32,35,1,2,1,1,NPC
BRD-K74711637_10uM_24h,BRD-K74711637,10 uM,24 h,3,29,32,1,35,9,26,NPC
BRD-K32111336_10uM_24h,BRD-K32111336,10 uM,24 h,3,29,32,1,10,4,6,NPC
EMF-BCA1-60_10uM_24h,EMF-BCA1-60,10 uM,24 h,3,27,30,1,189,61,128,NPC
BRD-A32214171_10uM_24h,BRD-A32214171,10 uM,24 h,3,27,30,1,16,2,14,NPC
morphothebaine_10uM_24h,morphothebaine,10 uM,24 h,3,32,35,1,0,0,0,NPC
H-7_10uM_24h,H-7,10 uM,24 h,3,29,32,1,0,0,0,NPC
LY-303511_10uM_24h,LY-303511,10 uM,24 h,3,32,35,1,48,17,31,NPC
BRD-K03122949_10uM_24h,BRD-K03122949,10 uM,24 h,3,27,30,1,98,30,68,NPC
BRD-A39121618_10uM_24h,BRD-A39121618,10 uM,24 h,3,27,30,1,92,44,48,NPC
GP-2a_10uM_24h,GP-2a,10 uM,24 h,3,32,35,1,1,0,1,NPC
SCH-442416_10uM_24h,SCH-442416,10 uM,24 h,3,32,35,1,0,0,0,NPC
NPI-2358_10uM_24h,NPI-2358,10 uM,24 h,3,29,32,1,3,1,2,NPC
BRD-A75471153_10uM_24h,BRD-A75471153,10 uM,24 h,3,27,30,1,0,0,0,NPC
BRD-A43188678_10uM_24h,BRD-A43188678,10 uM,24 h,3,27,30,1,2,2,0,NPC
QL-X-138_10uM_24h,QL-X-138,10 uM,24 h,3,29,32,1,168,54,114,NPC
BRD-K38455110_10uM_24h,BRD-K38455110,10 uM,24 h,3,27,30,1,0,0,0,NPC
ST-012525_10uM_24h,ST-012525,10 uM,24 h,3,27,30,1,0,0,0,NPC
O-3M3FBS_10uM_24h,O-3M3FBS,10 uM,24 h,3,28,31,1,0,0,0,NPC
BRD-K35568648_10uM_24h,BRD-K35568648,10 uM,24 h,3,29,32,1,0,0,0,NPC
BRD-K40094191_10uM_24h,BRD-K40094191,10 uM,24 h,3,29,32,1,3,0,3,NPC
BRD-K59341874_10uM_24h,BRD-K59341874,10 uM,24 h,3,54,57,1,8,1,7,NPC
BRD-K00256608_10uM_24h,BRD-K00256608,10 uM,24 h,3,54,57,1,9,1,8,NPC
SA-1458306_10uM_24h,SA-1458306,10 uM,24 h,3,54,57,1,0,0,0,NPC
BRD-K30837577_10uM_24h,BRD-K30837577,10 uM,24 h,3,45,48,1,4,3,1,NPC
BRD-K16827616_10uM_24h,BRD-K16827616,10 uM,24 h,3,45,48,1,277,75,202,NPC
BRD-K49669601_10uM_24h,BRD-K49669601,10 uM,24 h,3,45,48,1,72,19,53,NPC
BRD-K57962577_10uM_24h,BRD-K57962577,10 uM,24 h,3,54,57,1,8,4,4,NPC
BRD-K74461819_10uM_24h,BRD-K74461819,10 uM,24 h,3,54,57,1,2,1,1,NPC
BRD-K27452198_10uM_24h,BRD-K27452198,10 uM,24 h,3,54,57,1,5,2,3,NPC
BRD-K19888970_10uM_24h,BRD-K19888970,10 uM,24 h,3,45,48,1,64,22,42,NPC
BRD-K63455741_10uM_24h,BRD-K63455741,10 uM,24 h,3,54,57,1,2,1,1,NPC
BRD-K32949592_10uM_24h,BRD-K32949592,10 uM,24 h,3,29,32,1,0,0,0,NPC
bisbenzimide_10uM_24h,bisbenzimide,10 uM,24 h,3,32,35,1,0,0,0,NPC
BRD-K90697054_10uM_24h,BRD-K90697054,10 uM,24 h,3,27,30,1,5,2,3,NPC
ST-056792_10uM_24h,ST-056792,10 uM,24 h,3,29,32,1,141,26,115,NPC
BRD-A77704559_10uM_24h,BRD-A77704559,10 uM,24 h,3,27,30,1,91,31,60,NPC
ST-012030_10uM_24h,ST-012030,10 uM,24 h,3,27,30,1,0,0,0,NPC
oxalomalic-acid_10uM_24h,oxalomalic-acid,10 uM,24 h,3,29,32,1,112,46,66,NPC
BRD-K60685007_10uM_24h,BRD-K60685007,10 uM,24 h,3,27,30,1,17,3,14,NPC
BRD-K01614657_10uM_24h,BRD-K01614657,10 uM,24 h,3,29,32,1,85,44,41,NPC
BRD-K31841256_10uM_24h,BRD-K31841256,10 uM,24 h,3,29,32,1,13,5,8,NPC
BRD-K00859168_10uM_24h,BRD-K00859168,10 uM,24 h,3,29,32,1,4,4,0,NPC
1-monopalmitin_10uM_24h,1-monopalmitin,10 uM,24 h,3,32,35,1,0,0,0,NPC
BRD-K32321439_10uM_24h,BRD-K32321439,10 uM,24 h,3,27,30,1,3,2,1,NPC
BRD-K05775306_10uM_24h,BRD-K05775306,10 uM,24 h,3,29,32,1,12,1,11,NPC
BRD-K14965640_10uM_24h,BRD-K14965640,10 uM,24 h,3,32,35,1,0,0,0,NPC
BRD-K95349679_10uM_24h,BRD-K95349679,10 uM,24 h,3,29,32,1,8,1,7,NPC
BRD-A32241587_10uM_24h,BRD-A32241587,10 uM,24 h,3,27,30,1,0,0,0,NPC
BRD-K44586044_10uM_24h,BRD-K44586044,10 uM,24 h,3,54,57,1,1,1,0,NPC
BRD-K62473229_10uM_24h,BRD-K62473229,10 uM,24 h,3,54,57,1,2,2,0,NPC
BRD-K67514995_10uM_24h,BRD-K67514995,10 uM,24 h,3,45,48,1,182,108,74,NPC
BRD-K95285735_10uM_24h,BRD-K95285735,10 uM,24 h,3,54,57,1,12,8,4,NPC
BRD-K88899793_10uM_24h,BRD-K88899793,10 uM,24 h,3,54,57,1,0,0,0,NPC
BRD-K38294617_10uM_24h,BRD-K38294617,10 uM,24 h,3,45,48,1,81,37,44,NPC
BRD-K73118655_10uM_24h,BRD-K73118655,10 uM,24 h,3,45,48,1,110,48,62,NPC
BRD-K62283710_10uM_24h,BRD-K62283710,10 uM,24 h,3,45,48,1,18,8,10,NPC
BRD-K60391168_10uM_24h,BRD-K60391168,10 uM,24 h,3,45,48,1,43,14,29,NPC
BRD-K08317416_10uM_24h,BRD-K08317416,10 uM,24 h,3,45,48,1,58,27,31,NPC
BRD-K41571462_10uM_24h,BRD-K41571462,10 uM,24 h,3,54,57,1,15,8,7,NPC
BRD-K20099363_10uM_24h,BRD-K20099363,10 uM,24 h,3,54,57,1,1,0,1,NPC
BRD-K73427206_10uM_24h,BRD-K73427206,10 uM,24 h,3,45,48,1,5,4,1,NPC
BRD-K05677905_10uM_24h,BRD-K05677905,10 uM,24 h,3,45,48,1,1,1,0,NPC
BRD-K57073585_10uM_24h,BRD-K57073585,10 uM,24 h,3,54,57,1,0,0,0,NPC
ebelactone-b_10uM_24h,ebelactone-b,10 uM,24 h,3,29,32,1,0,0,0,NPC
SEW-00445_10uM_24h,SEW-00445,10 uM,24 h,3,27,30,1,0,0,0,NPC
BRD-K81609421_10uM_24h,BRD-K81609421,10 uM,24 h,3,27,30,1,1,1,0,NPC
BRD-K37618507_10uM_24h,BRD-K37618507,10 uM,24 h,3,29,32,1,0,0,0,NPC
BRD-K30958640_10uM_24h,BRD-K30958640,10 uM,24 h,3,29,32,1,0,0,0,NPC
BRD-K78596368_10uM_24h,BRD-K78596368,10 uM,24 h,3,27,30,1,0,0,0,NPC
BRD-K40300908_10uM_24h,BRD-K40300908,10 uM,24 h,3,29,32,1,0,0,0,NPC
BRD-K06765193_10uM_24h,BRD-K06765193,10 uM,24 h,3,27,30,1,132,42,90,NPC
RAN-29_10uM_24h,RAN-29,10 uM,24 h,3,27,30,1,39,17,22,NPC
BRD-K27170250_10uM_24h,BRD-K27170250,10 uM,24 h,3,29,32,1,1,0,1,NPC
HNHA_10uM_24h,HNHA,10 uM,24 h,3,29,32,1,11,2,9,NPC
BRD-K70771662_10uM_24h,BRD-K70771662,10 uM,24 h,3,29,32,1,211,55,156,NPC
BRD-K91485395_10uM_24h,BRD-K91485395,10 uM,24 h,3,29,32,1,1,0,1,NPC
cinobufagin_10uM_24h,cinobufagin,10 uM,24 h,3,30,33,1,558,239,319,NPC
RAN-03_10uM_24h,RAN-03,10 uM,24 h,3,29,32,1,2,2,0,NPC
BRD-K75128590_10uM_24h,BRD-K75128590,10 uM,24 h,3,29,32,1,1,0,1,NPC
BRD-K15672523_10uM_24h,BRD-K15672523,10 uM,24 h,3,27,30,1,3,1,2,NPC
propylpyrazole_10uM_24h,propylpyrazole,10 uM,24 h,3,29,32,1,0,0,0,NPC
BRD-A73847809_10uM_24h,BRD-A73847809,10 uM,24 h,3,29,32,1,1,0,1,NPC
BRD-K76856691_10uM_24h,BRD-K76856691,10 uM,24 h,3,54,57,1,4,2,2,NPC
BRD-K14352739_10uM_24h,BRD-K14352739,10 uM,24 h,3,54,57,1,19,9,10,NPC
BRD-K92953840_10uM_24h,BRD-K92953840,10 uM,24 h,3,45,48,1,107,36,71,NPC
BRD-K27597389_10uM_24h,BRD-K27597389,10 uM,24 h,3,54,57,1,1,1,0,NPC
BRD-K60212338_10uM_24h,BRD-K60212338,10 uM,24 h,3,45,48,1,51,15,36,NPC
BRD-K40963620_10uM_24h,BRD-K40963620,10 uM,24 h,3,45,48,1,34,14,20,NPC
BRD-K64062072_10uM_24h,BRD-K64062072,10 uM,24 h,3,54,57,1,3,3,0,NPC
BRD-K38622866_10uM_24h,BRD-K38622866,10 uM,24 h,3,54,57,1,4,1,3,NPC
BRD-K64523453_10uM_24h,BRD-K64523453,10 uM,24 h,3,45,48,1,40,14,26,NPC
BRD-K01877724_10uM_24h,BRD-K01877724,10 uM,24 h,3,54,57,1,3,0,3,NPC
BRD-K45627302_10uM_24h,BRD-K45627302,10 uM,24 h,3,45,48,1,108,61,47,NPC
SA-1459020_10uM_24h,SA-1459020,10 uM,24 h,3,45,48,1,0,0,0,NPC
BRD-K24890551_10uM_24h,BRD-K24890551,10 uM,24 h,3,45,48,1,6,4,2,NPC
BRD-K89824424_10uM_24h,BRD-K89824424,10 uM,24 h,3,54,57,1,7,5,2,NPC
BRD-K42454450_10uM_24h,BRD-K42454450,10 uM,24 h,3,45,48,1,11,6,5,NPC
BRD-K72343629_10uM_24h,BRD-K72343629,10 uM,24 h,3,45,48,1,32,14,18,NPC
BRD-K07666543_10uM_24h,BRD-K07666543,10 uM,24 h,3,54,57,1,7,4,3,NPC
BRD-K99638701_10uM_24h,BRD-K99638701,10 uM,24 h,3,45,48,1,46,20,26,NPC
BRD-K47071092_10uM_24h,BRD-K47071092,10 uM,24 h,3,54,57,1,5,4,1,NPC
BRD-K86048057_10uM_24h,BRD-K86048057,10 uM,24 h,3,45,48,1,322,178,144,NPC
BRD-K21498052_10uM_24h,BRD-K21498052,10 uM,24 h,3,54,57,1,6,2,4,NPC
SU-11652_10uM_24h,SU-11652,10 uM,24 h,3,31,34,1,89,31,58,NPC
BRD-K78701355_10uM_24h,BRD-K78701355,10 uM,24 h,3,29,32,1,2,0,2,NPC
SA-792709_10uM_24h,SA-792709,10 uM,24 h,3,32,35,1,4,4,0,NPC
BRD-K90446118_10uM_24h,BRD-K90446118,10 uM,24 h,3,29,32,1,3,1,2,NPC
BRD-A88029023_10uM_24h,BRD-A88029023,10 uM,24 h,3,29,32,1,0,0,0,NPC
BRD-K64985742_10uM_24h,BRD-K64985742,10 uM,24 h,3,29,32,1,5,1,4,NPC
BRD-K00824317_10uM_24h,BRD-K00824317,10 uM,24 h,3,32,35,1,0,0,0,NPC
BRD-U31801276_10uM_24h,BRD-U31801276,10 uM,24 h,3,29,32,1,1,1,0,NPC
BRD-K07161233_10uM_24h,BRD-K07161233,10 uM,24 h,3,27,30,1,37,13,24,NPC
ST-4029487_10uM_24h,ST-4029487,10 uM,24 h,3,27,30,1,0,0,0,NPC
isorotenone_10uM_24h,isorotenone,10 uM,24 h,3,32,35,1,4,3,1,NPC
BRD-K41924482_10uM_24h,BRD-K41924482,10 uM,24 h,3,29,32,1,0,0,0,NPC
BRD-K72451865_10uM_24h,BRD-K72451865,10 uM,24 h,3,27,30,1,0,0,0,NPC
BRD-K70821460_10uM_24h,BRD-K70821460,10 uM,24 h,3,32,35,1,1,1,0,NPC
prostaglandin_10uM_24h,prostaglandin,10 uM,24 h,3,29,32,1,2,2,0,NPC
BRD-A88504692_10uM_24h,BRD-A88504692,10 uM,24 h,3,29,32,1,1,1,0,NPC
BRD-K15107389_10uM_24h,BRD-K15107389,10 uM,24 h,3,27,30,1,0,0,0,NPC
BRD-K74931283_10uM_24h,BRD-K74931283,10 uM,24 h,3,27,30,1,2,1,1,NPC
BRD-K33392208_10uM_24h,BRD-K33392208,10 uM,24 h,3,29,32,1,1,0,1,NPC
ST-024029_10uM_24h,ST-024029,10 uM,24 h,3,29,32,1,0,0,0,NPC
BRD-K86110682_10uM_24h,BRD-K86110682,10 uM,24 h,3,29,32,1,2,2,0,NPC
razoxane_10uM_24h,razoxane,10 uM,24 h,3,29,32,1,2,1,1,NPC
BRD-K87730440_10uM_24h,BRD-K87730440,10 uM,24 h,3,29,32,1,0,0,0,NPC
BRD-A77577770_10uM_24h,BRD-A77577770,10 uM,24 h,3,29,32,1,2,1,1,NPC
TUL-XIX029_10uM_24h,TUL-XIX029,10 uM,24 h,3,29,32,1,0,0,0,NPC
LY-364947_10uM_24h,LY-364947,10 uM,24 h,3,32,35,1,0,0,0,NPC
BRD-K60796852_10uM_24h,BRD-K60796852,10 uM,24 h,3,45,48,1,3,1,2,NPC
BRD-K01608965_10uM_24h,BRD-K01608965,10 uM,24 h,3,45,48,1,37,15,22,NPC
BRD-K84651951_10uM_24h,BRD-K84651951,10 uM,24 h,3,45,48,1,2,0,2,NPC
BRD-K36462169_10uM_24h,BRD-K36462169,10 uM,24 h,3,54,57,1,10,9,1,NPC
BRD-K25990552_10uM_24h,BRD-K25990552,10 uM,24 h,3,54,57,1,12,6,6,NPC
BRD-K60637442_10uM_24h,BRD-K60637442,10 uM,24 h,3,54,57,1,5,2,3,NPC
BRD-K18396390_10uM_24h,BRD-K18396390,10 uM,24 h,3,54,57,1,1,1,0,NPC
BRD-K15918270_10uM_24h,BRD-K15918270,10 uM,24 h,3,54,57,1,1,0,1,NPC
BRD-K31949858_10uM_24h,BRD-K31949858,10 uM,24 h,3,45,48,1,35,16,19,NPC
BRD-K12411950_10uM_24h,BRD-K12411950,10 uM,24 h,3,54,57,1,1,1,0,NPC
BRD-K41871066_10uM_24h,BRD-K41871066,10 uM,24 h,3,54,57,1,0,0,0,NPC
SA-1921617_10uM_24h,SA-1921617,10 uM,24 h,3,45,48,1,98,44,54,NPC
BRD-K06589444_10uM_24h,BRD-K06589444,10 uM,24 h,3,45,48,1,159,87,72,NPC
huperzine-a_10uM_24h,huperzine-a,10 uM,24 h,3,29,32,1,137,103,34,NPC
BRD-K81314178_10uM_24h,BRD-K81314178,10 uM,24 h,3,29,32,1,0,0,0,NPC
BRD-K84677391_10uM_24h,BRD-K84677391,10 uM,24 h,3,27,30,1,0,0,0,NPC
BRD-K09661167_10uM_24h,BRD-K09661167,10 uM,24 h,3,29,32,1,20,7,13,NPC
TUL-XXI039_10uM_24h,TUL-XXI039,10 uM,24 h,3,29,32,1,4,0,4,NPC
I-212148_10uM_24h,I-212148,10 uM,24 h,3,29,32,1,10,4,6,NPC
A-23187_10uM_24h,A-23187,10 uM,24 h,3,31,34,1,402,136,266,NPC
timosaponin_10uM_6h,timosaponin,10 uM,6 h,3,28,31,1,0,0,0,NPC
BRD-K22828860_10uM_24h,BRD-K22828860,10 uM,24 h,3,29,32,1,16,2,14,NPC
BRD-K76236182_10uM_24h,BRD-K76236182,10 uM,24 h,3,27,30,1,181,63,118,NPC
BRD-K53472085_10uM_24h,BRD-K53472085,10 uM,24 h,3,29,32,1,0,0,0,NPC
BRD-K41925105_10uM_24h,BRD-K41925105,10 uM,24 h,3,27,30,1,0,0,0,NPC
BRD-A09164687_10uM_24h,BRD-A09164687,10 uM,24 h,3,27,30,1,34,4,30,NPC
tyrphostin-B44_10uM_24h,tyrphostin-B44,10 uM,24 h,3,32,35,1,1,1,0,NPC
BRD-K67470788_10uM_24h,BRD-K67470788,10 uM,24 h,3,29,32,1,0,0,0,NPC
BRD-K06800040_10uM_24h,BRD-K06800040,10 uM,24 h,3,29,32,1,6,4,2,NPC
EMF-sumo1-9_10uM_24h,EMF-sumo1-9,10 uM,24 h,3,29,32,1,6,1,5,NPC
phenanthridone_10uM_24h,phenanthridone,10 uM,24 h,3,32,35,1,0,0,0,NPC
CAY-10577_10uM_24h,CAY-10577,10 uM,24 h,3,29,32,1,6,3,3,NPC
BRD-A15914070_10uM_24h,BRD-A15914070,10 uM,24 h,3,32,35,1,1,0,1,NPC
RAN-14B_10uM_24h,RAN-14B,10 uM,24 h,3,27,30,1,14,8,6,NPC
CAY-10585_10uM_24h,CAY-10585,10 uM,24 h,3,29,32,1,0,0,0,NPC
BRD-K20827972_10uM_24h,BRD-K20827972,10 uM,24 h,3,45,48,1,12,5,7,NPC
BRD-K40506152_10uM_24h,BRD-K40506152,10 uM,24 h,3,54,57,1,4,4,0,NPC
BRD-K25427024_10uM_24h,BRD-K25427024,10 uM,24 h,3,54,57,1,2,2,0,NPC
BRD-K85205404_10uM_24h,BRD-K85205404,10 uM,24 h,3,54,57,1,4,2,2,NPC
BRD-K78528600_10uM_24h,BRD-K78528600,10 uM,24 h,3,54,57,1,2,1,1,NPC
BRD-K28083085_10uM_24h,BRD-K28083085,10 uM,24 h,3,45,48,1,57,33,24,NPC
BRD-K17890048_10uM_24h,BRD-K17890048,10 uM,24 h,3,45,48,1,45,14,31,NPC
BRD-K69500068_10uM_24h,BRD-K69500068,10 uM,24 h,3,45,48,1,21,7,14,NPC
BRD-K62919978_10uM_24h,BRD-K62919978,10 uM,24 h,3,54,57,1,2,1,1,NPC
BRD-K34160774_10uM_24h,BRD-K34160774,10 uM,24 h,3,54,57,1,22,6,16,NPC
BRD-K80666761_10uM_24h,BRD-K80666761,10 uM,24 h,3,45,48,1,29,16,13,NPC
BRD-K99718824_10uM_24h,BRD-K99718824,10 uM,24 h,3,45,48,1,66,28,38,NPC
BRD-K30633722_10uM_24h,BRD-K30633722,10 uM,24 h,3,54,57,1,3,3,0,NPC
BRD-K42543764_10uM_24h,BRD-K42543764,10 uM,24 h,3,45,48,1,19,8,11,NPC
BRD-K55149044_10uM_24h,BRD-K55149044,10 uM,24 h,3,54,57,1,9,5,4,NPC
BRD-K91701366_10uM_24h,BRD-K91701366,10 uM,24 h,3,45,48,1,3,1,2,NPC
BRD-K86786416_10uM_24h,BRD-K86786416,10 uM,24 h,3,45,48,1,80,19,61,NPC
BRD-K42702351_10uM_24h,BRD-K42702351,10 uM,24 h,3,45,48,1,118,43,75,NPC
BRD-K88279116_10uM_24h,BRD-K88279116,10 uM,24 h,3,45,48,1,13,8,5,NPC
hyperforin_10uM_24h,hyperforin,10 uM,24 h,3,29,32,1,2,1,1,NPC
BRD-K59488055_10uM_24h,BRD-K59488055,10 uM,24 h,3,29,32,1,4,2,2,NPC
fraxetin_10uM_24h,fraxetin,10 uM,24 h,3,32,35,1,0,0,0,NPC
thapsigargin_10uM_24h,thapsigargin,10 uM,24 h,3,31,34,1,399,138,261,NPC
BRD-K64525051_10uM_24h,BRD-K64525051,10 uM,24 h,3,27,30,1,25,10,15,NPC
BRD-A43087975_10uM_24h,BRD-A43087975,10 uM,24 h,3,27,30,1,0,0,0,NPC
BRD-A17718497_10uM_24h,BRD-A17718497,10 uM,24 h,3,29,32,1,2,1,1,NPC
NK26-I-41-1_10uM_24h,NK26-I-41-1,10 uM,24 h,3,27,30,1,1,0,1,NPC
BRD-A03946276_10uM_24h,BRD-A03946276,10 uM,24 h,3,29,32,1,1,1,0,NPC
ST-4070043_10uM_24h,ST-4070043,10 uM,24 h,3,29,32,1,1,1,0,NPC
EMF-sumo1-6_10uM_24h,EMF-sumo1-6,10 uM,24 h,3,29,32,1,1,1,0,NPC
BRD-K22129929_10uM_24h,BRD-K22129929,10 uM,24 h,3,29,32,1,0,0,0,NPC
BRD-K73155123_10uM_24h,BRD-K73155123,10 uM,24 h,3,29,32,1,10,5,5,NPC
BRD-K06311439_10uM_24h,BRD-K06311439,10 uM,24 h,3,27,30,1,3,3,0,NPC
BRD-K51791390_10uM_24h,BRD-K51791390,10 uM,24 h,3,29,32,1,0,0,0,NPC
QL-XII-47_10uM_24h,QL-XII-47,10 uM,24 h,3,29,32,1,314,124,190,NPC
BRD-K74623475_10uM_24h,BRD-K74623475,10 uM,24 h,3,27,30,1,0,0,0,NPC
BRD-K02223034_10uM_24h,BRD-K02223034,10 uM,24 h,3,29,32,1,3,3,0,NPC
BRD-K46047563_10uM_24h,BRD-K46047563,10 uM,24 h,3,54,57,1,2,1,1,NPC
BRD-K54636101_10uM_24h,BRD-K54636101,10 uM,24 h,3,45,48,1,8,4,4,NPC
BRD-K43842808_10uM_24h,BRD-K43842808,10 uM,24 h,3,54,57,1,1,0,1,NPC
BRD-K32301393_10uM_24h,BRD-K32301393,10 uM,24 h,3,54,57,1,2,0,2,NPC
BRD-K84797952_10uM_24h,BRD-K84797952,10 uM,24 h,3,54,57,1,8,3,5,NPC
BRD-K44787412_10uM_24h,BRD-K44787412,10 uM,24 h,3,45,48,1,36,16,20,NPC
BRD-K92656786_10uM_24h,BRD-K92656786,10 uM,24 h,3,54,57,1,4,1,3,NPC
BRD-K87920375_10uM_24h,BRD-K87920375,10 uM,24 h,3,45,48,1,6,3,3,NPC
BRD-K41700431_10uM_24h,BRD-K41700431,10 uM,24 h,3,45,48,1,85,37,48,NPC
BRD-K42107428_10uM_24h,BRD-K42107428,10 uM,24 h,3,45,48,1,10,5,5,NPC
BRD-K43568193_10uM_24h,BRD-K43568193,10 uM,24 h,3,45,48,1,142,42,100,NPC
diflorasone_10uM_24h,diflorasone,10 uM,24 h,3,32,35,1,0,0,0,NPC
BRD-K36087356_10uM_24h,BRD-K36087356,10 uM,24 h,3,29,32,1,22,2,20,NPC
BRD-K26548821_10uM_24h,BRD-K26548821,10 uM,24 h,3,32,35,1,0,0,0,NPC
BRD-K72381041_10uM_24h,BRD-K72381041,10 uM,24 h,3,27,30,1,4,1,3,NPC
SYK-inhibitor_10uM_24h,SYK-inhibitor,10 uM,24 h,3,26,29,1,36,21,15,NPC
BRD-K44893543_10uM_24h,BRD-K44893543,10 uM,24 h,3,29,32,1,1,0,1,NPC
BRD-K95080859_10uM_24h,BRD-K95080859,10 uM,24 h,3,29,32,1,2,0,2,NPC
BRD-K16309743_10uM_24h,BRD-K16309743,10 uM,24 h,3,29,32,1,0,0,0,NPC
BRD-K07395346_10uM_24h,BRD-K07395346,10 uM,24 h,3,27,30,1,58,20,38,NPC
BRD-K81441552_10uM_24h,BRD-K81441552,10 uM,24 h,3,29,32,1,4,2,2,NPC
sphingosine_10uM_24h,sphingosine,10 uM,24 h,3,29,32,1,2,1,1,NPC
BRD-K07023879_10uM_24h,BRD-K07023879,10 uM,24 h,3,29,32,1,0,0,0,NPC
BRD-K28293491_10uM_24h,BRD-K28293491,10 uM,24 h,3,27,30,1,0,0,0,NPC
MW-A1-2_10uM_24h,MW-A1-2,10 uM,24 h,3,29,32,1,8,1,7,NPC
BRD-K32782699_10uM_24h,BRD-K32782699,10 uM,24 h,3,45,48,1,1,0,1,NPC
BRD-K69705756_10uM_24h,BRD-K69705756,10 uM,24 h,3,54,57,1,1,1,0,NPC
BRD-K96703623_10uM_24h,BRD-K96703623,10 uM,24 h,3,45,48,1,163,39,124,NPC
BRD-K59805090_10uM_24h,BRD-K59805090,10 uM,24 h,3,45,48,1,1,0,1,NPC
BRD-K82927587_10uM_24h,BRD-K82927587,10 uM,24 h,3,54,57,1,1,1,0,NPC
BRD-K95041551_10uM_24h,BRD-K95041551,10 uM,24 h,3,45,48,1,27,15,12,NPC
BRD-K25436320_10uM_24h,BRD-K25436320,10 uM,24 h,3,45,48,1,6,3,3,NPC
BRD-K97873029_10uM_24h,BRD-K97873029,10 uM,24 h,3,54,57,1,3,3,0,NPC
BRD-K30563708_10uM_24h,BRD-K30563708,10 uM,24 h,3,54,57,1,2,1,1,NPC
BRD-K19390271_10uM_24h,BRD-K19390271,10 uM,24 h,3,54,57,1,1,1,0,NPC
BRD-K42568865_10uM_24h,BRD-K42568865,10 uM,24 h,3,29,32,1,35,5,30,NPC
BRD-K66866270_10uM_24h,BRD-K66866270,10 uM,24 h,3,27,30,1,0,0,0,NPC
STK-674938_10uM_24h,STK-674938,10 uM,24 h,3,29,32,1,11,1,10,NPC
lavendustin-c_10uM_24h,lavendustin-c,10 uM,24 h,3,29,32,1,3,2,1,NPC
BRD-K86631041_10uM_24h,BRD-K86631041,10 uM,24 h,3,27,30,1,53,18,35,NPC
ARP-101_10uM_24h,ARP-101,10 uM,24 h,3,32,35,1,3,2,1,NPC
BRD-K89156937_10uM_24h,BRD-K89156937,10 uM,24 h,3,29,32,1,0,0,0,NPC
BRD-A36059655_10uM_24h,BRD-A36059655,10 uM,24 h,3,29,32,1,1,0,1,NPC
BRD-K42644990_10uM_24h,BRD-K42644990,10 uM,24 h,3,27,30,1,26,8,18,NPC
BRD-K97701319_10uM_24h,BRD-K97701319,10 uM,24 h,3,29,32,1,3,2,1,NPC
EI-247_10uM_24h,EI-247,10 uM,24 h,3,29,32,1,7,3,4,NPC
MW-STK33-3A_10uM_24h,MW-STK33-3A,10 uM,24 h,3,29,32,1,1,0,1,NPC
BRD-K97631938_10uM_24h,BRD-K97631938,10 uM,24 h,3,29,32,1,1,1,0,NPC
BRD-K67258146_10uM_24h,BRD-K67258146,10 uM,24 h,3,29,32,1,4,0,4,NPC
BRD-K99433267_10uM_24h,BRD-K99433267,10 uM,24 h,3,27,30,1,0,0,0,NPC
BRD-K86693415_10uM_24h,BRD-K86693415,10 uM,24 h,3,29,32,1,22,3,19,NPC
ST-023431_10uM_24h,ST-023431,10 uM,24 h,3,27,30,1,49,20,29,NPC
xanthohumol_10uM_24h,xanthohumol,10 uM,24 h,3,29,32,1,1,1,0,NPC
BRD-K21037590_10uM_24h,BRD-K21037590,10 uM,24 h,3,45,48,1,8,1,7,NPC
BRD-K79793579_10uM_24h,BRD-K79793579,10 uM,24 h,3,54,57,1,11,7,4,NPC
BRD-K53475565_10uM_24h,BRD-K53475565,10 uM,24 h,3,45,48,1,95,32,63,NPC
BRD-K91834385_10uM_24h,BRD-K91834385,10 uM,24 h,3,54,57,1,0,0,0,NPC
BRD-K31302860_10uM_24h,BRD-K31302860,10 uM,24 h,3,54,57,1,5,2,3,NPC
BRD-K16752617_10uM_24h,BRD-K16752617,10 uM,24 h,3,45,48,1,11,4,7,NPC
BRD-K53407305_10uM_24h,BRD-K53407305,10 uM,24 h,3,45,48,1,70,25,45,NPC
BRD-K12916986_10uM_24h,BRD-K12916986,10 uM,24 h,3,54,57,1,31,13,18,NPC
BRD-K79532217_10uM_24h,BRD-K79532217,10 uM,24 h,3,54,57,1,100,45,55,NPC
BRD-K90143908_10uM_24h,BRD-K90143908,10 uM,24 h,3,45,48,1,4,3,1,NPC
SA-1925996_10uM_24h,SA-1925996,10 uM,24 h,3,54,57,1,223,89,134,NPC
BRD-K57166447_10uM_24h,BRD-K57166447,10 uM,24 h,3,45,48,1,13,6,7,NPC
BRD-K61717269_10uM_24h,BRD-K61717269,10 uM,24 h,3,29,32,1,207,103,104,NPC
SPB02303_10uM_24h,SPB02303,10 uM,24 h,3,29,32,1,30,28,2,NPC
BRD-K22384978_10uM_24h,BRD-K22384978,10 uM,24 h,3,27,30,1,0,0,0,NPC
ST-019386_10uM_24h,ST-019386,10 uM,24 h,3,27,30,1,42,12,30,NPC
BRD-K10484463_10uM_24h,BRD-K10484463,10 uM,24 h,3,29,32,1,1,0,1,NPC
ST-019365_10uM_24h,ST-019365,10 uM,24 h,3,27,30,1,19,3,16,NPC
BRD-K74606027_10uM_24h,BRD-K74606027,10 uM,24 h,3,27,30,1,1,0,1,NPC
BRD-K98731749_10uM_24h,BRD-K98731749,10 uM,24 h,3,29,32,1,283,145,138,NPC
BRD-A07614565_10uM_24h,BRD-A07614565,10 uM,24 h,3,27,30,1,25,10,15,NPC
HG-5-113-01_10uM_24h,HG-5-113-01,10 uM,24 h,3,27,30,1,31,12,19,NPC
BRD-K00954209_10uM_24h,BRD-K00954209,10 uM,24 h,3,27,30,1,4,2,2,NPC
fluperlapine_10uM_24h,fluperlapine,10 uM,24 h,3,32,35,1,4,2,2,NPC
cytochalasin-d_10uM_24h,cytochalasin-d,10 uM,24 h,3,27,30,1,14,5,9,NPC
MW-STK33-3B_10uM_24h,MW-STK33-3B,10 uM,24 h,3,29,32,1,6,2,4,NPC
BRD-K09191212_10uM_24h,BRD-K09191212,10 uM,24 h,3,29,32,1,0,0,0,NPC
BRD-K12238169_10uM_24h,BRD-K12238169,10 uM,24 h,3,29,32,1,0,0,0,NPC
BRD-K70900504_10uM_24h,BRD-K70900504,10 uM,24 h,3,45,48,1,7,3,4,NPC
BRD-K00859238_10uM_24h,BRD-K00859238,10 uM,24 h,3,54,57,1,3,3,0,NPC
BRD-K36984542_10uM_24h,BRD-K36984542,10 uM,24 h,3,54,57,1,2,2,0,NPC
BRD-K23985857_10uM_24h,BRD-K23985857,10 uM,24 h,3,45,48,1,10,6,4,NPC
BRD-K69295800_10uM_24h,BRD-K69295800,10 uM,24 h,3,54,57,1,6,3,3,NPC
BRD-K40064462_10uM_24h,BRD-K40064462,10 uM,24 h,3,54,57,1,2,1,1,NPC
BRD-K77629773_10uM_24h,BRD-K77629773,10 uM,24 h,3,54,57,1,0,0,0,NPC
BRD-K47771675_10uM_24h,BRD-K47771675,10 uM,24 h,3,54,57,1,9,2,7,NPC
BRD-K59253994_10uM_24h,BRD-K59253994,10 uM,24 h,3,45,48,1,24,14,10,NPC
BRD-K12124649_10uM_24h,BRD-K12124649,10 uM,24 h,3,54,57,1,1,0,1,NPC
SA-1921456_10uM_24h,SA-1921456,10 uM,24 h,3,45,48,1,32,10,22,NPC
BRD-K87313043_10uM_24h,BRD-K87313043,10 uM,24 h,3,54,57,1,5,2,3,NPC
BRD-K37669227_10uM_24h,BRD-K37669227,10 uM,24 h,3,45,48,1,16,10,6,NPC
BRD-K97114030_10uM_24h,BRD-K97114030,10 uM,24 h,3,54,57,1,0,0,0,NPC
BRD-K56518176_10uM_24h,BRD-K56518176,10 uM,24 h,3,29,32,1,1,0,1,NPC
5-methoxytryptamine_10uM_24h,5-methoxytryptamine,10 uM,24 h,3,32,35,1,0,0,0,NPC
ST-4070169_10uM_24h,ST-4070169,10 uM,24 h,3,27,30,1,1,0,1,NPC
BRD-K77987635_10uM_24h,BRD-K77987635,10 uM,24 h,3,27,30,1,10,5,5,NPC
BRD-K83691318_10uM_24h,BRD-K83691318,10 uM,24 h,3,29,32,1,2,1,1,NPC
CVF-SUMO-13_10uM_24h,CVF-SUMO-13,10 uM,24 h,3,29,32,1,15,3,12,NPC
BRD-K44540157_10uM_24h,BRD-K44540157,10 uM,24 h,3,27,30,1,230,90,140,NPC
BRD-K43581698_10uM_24h,BRD-K43581698,10 uM,24 h,3,27,30,1,20,7,13,NPC
L-2167_10uM_24h,L-2167,10 uM,24 h,3,29,32,1,3,1,2,NPC
EMF-BCA1-57_10uM_24h,EMF-BCA1-57,10 uM,24 h,3,29,32,1,5,3,2,NPC
BRD-K17693482_10uM_24h,BRD-K17693482,10 uM,24 h,3,32,35,1,1,1,0,NPC
BRD-K37727696_10uM_24h,BRD-K37727696,10 uM,24 h,3,29,32,1,5,2,3,NPC
BRD-A41997916_10uM_24h,BRD-A41997916,10 uM,24 h,3,27,30,1,136,46,90,NPC
BRD-K59939374_10uM_24h,BRD-K59939374,10 uM,24 h,3,29,32,1,7,3,4,NPC
BRD-K33606495_10uM_24h,BRD-K33606495,10 uM,24 h,3,27,30,1,0,0,0,NPC
BRD-K37762845_10uM_24h,BRD-K37762845,10 uM,24 h,3,29,32,1,2,1,1,NPC
BRD-K95033227_10uM_24h,BRD-K95033227,10 uM,24 h,3,45,48,1,10,5,5,NPC
BRD-K98626176_10uM_24h,BRD-K98626176,10 uM,24 h,3,45,48,1,27,12,15,NPC
BRD-K40185230_10uM_24h,BRD-K40185230,10 uM,24 h,3,54,57,1,2,2,0,NPC
BRD-K85197047_10uM_24h,BRD-K85197047,10 uM,24 h,3,45,48,1,44,20,24,NPC
BRD-K15973523_10uM_24h,BRD-K15973523,10 uM,24 h,3,54,57,1,0,0,0,NPC
BRD-K23319301_10uM_24h,BRD-K23319301,10 uM,24 h,3,45,48,1,181,78,103,NPC
SA-1939936_10uM_24h,SA-1939936,10 uM,24 h,3,45,48,1,6,5,1,NPC
BRD-K93763482_10uM_24h,BRD-K93763482,10 uM,24 h,3,45,48,1,15,7,8,NPC
BRD-K69075782_10uM_24h,BRD-K69075782,10 uM,24 h,3,54,57,1,2,2,0,NPC
BRD-K71151012_10uM_24h,BRD-K71151012,10 uM,24 h,3,45,48,1,7,6,1,NPC
BRD-K19436903_10uM_24h,BRD-K19436903,10 uM,24 h,3,54,57,1,4,1,3,NPC
depudecin_10uM_24h,depudecin,10 uM,24 h,3,27,30,1,10,6,4,NPC
ST-003833_10uM_24h,ST-003833,10 uM,24 h,3,29,32,1,1,1,0,NPC
BRD-K72615639_10uM_24h,BRD-K72615639,10 uM,24 h,3,29,32,1,16,1,15,NPC
BRD-U08759356_10uM_24h,BRD-U08759356,10 uM,24 h,3,29,32,1,0,0,0,NPC
ST-012015_10uM_24h,ST-012015,10 uM,24 h,3,29,32,1,6,1,5,NPC
BRD-K70974948_10uM_24h,BRD-K70974948,10 uM,24 h,3,27,30,1,71,32,39,NPC
BRD-A82628254_10uM_24h,BRD-A82628254,10 uM,24 h,3,27,30,1,13,4,9,NPC
BRD-K74949371_10uM_24h,BRD-K74949371,10 uM,24 h,3,27,30,1,180,59,121,NPC
BRD-K31754360_10uM_24h,BRD-K31754360,10 uM,24 h,3,27,30,1,0,0,0,NPC
BRD-K93578426_10uM_24h,BRD-K93578426,10 uM,24 h,3,27,30,1,170,58,112,NPC
BRD-K71292008_10uM_24h,BRD-K71292008,10 uM,24 h,3,29,32,1,0,0,0,NPC
BRD-K38205437_10uM_24h,BRD-K38205437,10 uM,24 h,3,29,32,1,0,0,0,NPC
BRD-A94381689_10uM_24h,BRD-A94381689,10 uM,24 h,3,27,30,1,57,18,39,NPC
BRD-K29622226_10uM_24h,BRD-K29622226,10 uM,24 h,3,27,30,1,6,1,5,NPC
BRD-K58547240_10uM_24h,BRD-K58547240,10 uM,24 h,3,27,30,1,33,9,24,NPC
BRD-K87426499_10uM_24h,BRD-K87426499,10 uM,24 h,3,27,30,1,0,0,0,NPC
BRD-A55565369_10uM_24h,BRD-A55565369,10 uM,24 h,3,29,32,1,11,2,9,NPC
BRD-K51329831_10uM_24h,BRD-K51329831,10 uM,24 h,3,54,57,1,6,2,4,NPC
BRD-K28636199_10uM_24h,BRD-K28636199,10 uM,24 h,3,45,48,1,12,3,9,NPC
BRD-K03013810_10uM_24h,BRD-K03013810,10 uM,24 h,3,54,57,1,5,3,2,NPC
BRD-K80553643_10uM_24h,BRD-K80553643,10 uM,24 h,3,54,57,1,3,2,1,NPC
BRD-K65426421_10uM_24h,BRD-K65426421,10 uM,24 h,3,54,57,1,1,0,1,NPC
BRD-K74046820_10uM_24h,BRD-K74046820,10 uM,24 h,3,45,48,1,47,11,36,NPC
BRD-K23488072_10uM_24h,BRD-K23488072,10 uM,24 h,3,45,48,1,8,1,7,NPC
BRD-K06816133_10uM_24h,BRD-K06816133,10 uM,24 h,3,54,57,1,4,2,2,NPC
BRD-K32389477_10uM_24h,BRD-K32389477,10 uM,24 h,3,45,48,1,4,2,2,NPC
BRD-K79793338_10uM_24h,BRD-K79793338,10 uM,24 h,3,45,48,1,63,23,40,NPC
BRD-K77888550_10uM_24h,BRD-K77888550,10 uM,24 h,3,45,48,1,109,27,82,NPC
BRD-K02117849_10uM_24h,BRD-K02117849,10 uM,24 h,3,54,57,1,1,1,0,NPC
BRD-K77644833_10uM_24h,BRD-K77644833,10 uM,24 h,3,54,57,1,3,1,2,NPC
BRD-K93158953_10uM_24h,BRD-K93158953,10 uM,24 h,3,45,48,1,170,60,110,NPC
BRD-K38024133_10uM_24h,BRD-K38024133,10 uM,24 h,3,54,57,1,3,1,2,NPC
BRD-K81527737_10uM_24h,BRD-K81527737,10 uM,24 h,3,45,48,1,25,12,13,NPC
BRD-K31295191_10uM_24h,BRD-K31295191,10 uM,24 h,3,54,57,1,2,1,1,NPC
BRD-K31975688_10uM_24h,BRD-K31975688,10 uM,24 h,3,45,48,1,38,16,22,NPC
BRD-K61753121_10uM_24h,BRD-K61753121,10 uM,24 h,3,54,57,1,6,2,4,NPC
BRD-K86671899_10uM_24h,BRD-K86671899,10 uM,24 h,3,45,48,1,178,104,74,NPC
BL-074_10uM_24h,BL-074,10 uM,24 h,3,29,32,1,0,0,0,NPC
CCCP_10uM_24h,CCCP,10 uM,24 h,3,32,35,1,74,37,37,NPC
BRD-K91671201_10uM_24h,BRD-K91671201,10 uM,24 h,3,29,32,1,7,0,7,NPC
BRD-K88569143_10uM_24h,BRD-K88569143,10 uM,24 h,3,29,32,1,0,0,0,NPC
BRD-K75329208_10uM_24h,BRD-K75329208,10 uM,24 h,3,29,32,1,13,3,10,NPC
BRD-K25375605_10uM_24h,BRD-K25375605,10 uM,24 h,3,29,32,1,0,0,0,NPC
BRD-K59980915_10uM_24h,BRD-K59980915,10 uM,24 h,3,29,32,1,3,1,2,NPC
BRD-K09460252_10uM_24h,BRD-K09460252,10 uM,24 h,3,27,30,1,21,9,12,NPC
BRD-K29715937_10uM_24h,BRD-K29715937,10 uM,24 h,3,29,32,1,16,4,12,NPC
BRD-A06909528_10uM_24h,BRD-A06909528,10 uM,24 h,3,27,30,1,194,73,121,NPC
BRD-K87432599_10uM_24h,BRD-K87432599,10 uM,24 h,3,29,32,1,0,0,0,NPC
BAS-09104376_10uM_24h,BAS-09104376,10 uM,24 h,3,27,30,1,0,0,0,NPC
BRD-K12168891_10uM_24h,BRD-K12168891,10 uM,24 h,3,29,32,1,5,1,4,NPC
BRD-K02882069_10uM_24h,BRD-K02882069,10 uM,24 h,3,54,57,1,2,2,0,NPC
BRD-K03354784_10uM_24h,BRD-K03354784,10 uM,24 h,3,54,57,1,4,2,2,NPC
BRD-K38700430_10uM_24h,BRD-K38700430,10 uM,24 h,3,45,48,1,42,15,27,NPC
BRD-K07381195_10uM_24h,BRD-K07381195,10 uM,24 h,3,45,48,1,19,11,8,NPC
BRD-K67236950_10uM_24h,BRD-K67236950,10 uM,24 h,3,54,57,1,23,12,11,NPC
BRD-K00409771_10uM_24h,BRD-K00409771,10 uM,24 h,3,54,57,1,0,0,0,NPC
BRD-K06898795_10uM_24h,BRD-K06898795,10 uM,24 h,3,54,57,1,1,1,0,NPC
BRD-K15524596_10uM_24h,BRD-K15524596,10 uM,24 h,3,54,57,1,8,6,2,NPC
BRD-K88114920_10uM_24h,BRD-K88114920,10 uM,24 h,3,54,57,1,4,3,1,NPC
BRD-K26359746_10uM_24h,BRD-K26359746,10 uM,24 h,3,45,48,1,12,5,7,NPC
BRD-K80169513_10uM_24h,BRD-K80169513,10 uM,24 h,3,54,57,1,89,39,50,NPC
BRD-K14475668_10uM_24h,BRD-K14475668,10 uM,24 h,3,45,48,1,9,4,5,NPC
BRD-K02952507_10uM_24h,BRD-K02952507,10 uM,24 h,3,54,57,1,6,3,3,NPC
BRD-K42541148_10uM_24h,BRD-K42541148,10 uM,24 h,3,29,32,1,0,0,0,NPC
BRD-K94572506_10uM_24h,BRD-K94572506,10 uM,24 h,3,29,32,1,3,1,2,NPC
BAS-00535043_10uM_24h,BAS-00535043,10 uM,24 h,3,29,32,1,1,0,1,NPC
BRD-K32485462_10uM_24h,BRD-K32485462,10 uM,24 h,3,29,32,1,0,0,0,NPC
BRD-A70541707_10uM_24h,BRD-A70541707,10 uM,24 h,3,34,37,2,9,2,7,NPC
BRD-K19875179_10uM_24h,BRD-K19875179,10 uM,24 h,3,29,32,1,0,0,0,NPC
eugenitol_10uM_24h,eugenitol,10 uM,24 h,3,32,35,1,0,0,0,NPC
BRD-K31553917_10uM_24h,BRD-K31553917,10 uM,24 h,3,29,32,1,1,0,1,NPC
BRD-K35004659_10uM_24h,BRD-K35004659,10 uM,24 h,3,29,32,1,0,0,0,NPC
BRD-K49403449_10uM_24h,BRD-K49403449,10 uM,24 h,3,29,32,1,0,0,0,NPC
BRD-K05593511_10uM_24h,BRD-K05593511,10 uM,24 h,3,29,32,1,0,0,0,NPC
BRD-K94352392_10uM_24h,BRD-K94352392,10 uM,24 h,3,29,32,1,1,0,1,NPC
BRD-K98519396_10uM_24h,BRD-K98519396,10 uM,24 h,3,27,30,1,0,0,0,NPC
OM-137_10uM_24h,OM-137,10 uM,24 h,3,29,32,1,0,0,0,NPC
BRD-K29345712_10uM_24h,BRD-K29345712,10 uM,24 h,3,29,32,1,60,31,29,NPC
BRD-A68274214_10uM_24h,BRD-A68274214,10 uM,24 h,3,27,30,1,0,0,0,NPC
BRD-K74733595_10uM_24h,BRD-K74733595,10 uM,24 h,3,29,32,1,2,1,1,NPC
BRD-K31380618_10uM_24h,BRD-K31380618,10 uM,24 h,3,54,57,1,8,2,6,NPC
BRD-K70345064_10uM_24h,BRD-K70345064,10 uM,24 h,3,45,48,1,63,22,41,NPC
BRD-K22080587_10uM_24h,BRD-K22080587,10 uM,24 h,3,45,48,1,11,3,8,NPC
BRD-K17554130_10uM_24h,BRD-K17554130,10 uM,24 h,3,54,57,1,0,0,0,NPC
BRD-K71387353_10uM_24h,BRD-K71387353,10 uM,24 h,3,45,48,1,12,7,5,NPC
BRD-K63388446_10uM_24h,BRD-K63388446,10 uM,24 h,3,45,48,1,12,8,4,NPC
SA-1459291_10uM_24h,SA-1459291,10 uM,24 h,3,54,57,1,4,3,1,NPC
BRD-K50748030_10uM_24h,BRD-K50748030,10 uM,24 h,3,45,48,1,17,7,10,NPC
BRD-K51998148_10uM_24h,BRD-K51998148,10 uM,24 h,3,29,32,1,20,10,10,NPC
BRD-K96326565_10uM_24h,BRD-K96326565,10 uM,24 h,3,29,32,1,14,8,6,NPC
ST-4042556_10uM_24h,ST-4042556,10 uM,24 h,3,27,30,1,6,4,2,NPC
WR-216174_10uM_24h,WR-216174,10 uM,24 h,3,31,34,1,127,54,73,NPC
BRD-K96752129_10uM_24h,BRD-K96752129,10 uM,24 h,3,29,32,1,0,0,0,NPC
BRD-K38690464_10uM_24h,BRD-K38690464,10 uM,24 h,3,29,32,1,8,1,7,NPC
BRD-A95937159_10uM_24h,BRD-A95937159,10 uM,24 h,3,29,32,1,1,1,0,NPC
BRD-K14790374_10uM_24h,BRD-K14790374,10 uM,24 h,3,29,32,1,2,2,0,NPC
BRD-A13346522_10uM_24h,BRD-A13346522,10 uM,24 h,3,29,32,1,1,1,0,NPC
MD-II-051_10uM_24h,MD-II-051,10 uM,24 h,3,29,32,1,0,0,0,NPC
BRD-K23313025_10uM_24h,BRD-K23313025,10 uM,24 h,3,29,32,1,6,0,6,NPC
BRD-K94991378_10uM_24h,BRD-K94991378,10 uM,24 h,3,29,32,1,186,51,135,NPC
U-46619_10uM_24h,U-46619,10 uM,24 h,3,32,35,1,0,0,0,NPC
BRD-K98991361_10uM_24h,BRD-K98991361,10 uM,24 h,3,29,32,1,0,0,0,NPC
BRD-K06476055_10uM_24h,BRD-K06476055,10 uM,24 h,3,27,30,1,0,0,0,NPC
K784-3188_10uM_24h,K784-3188,10 uM,24 h,3,29,32,1,20,9,11,NPC
5-methylhydantoin_10uM_24h,5-methylhydantoin,10 uM,24 h,3,32,35,1,0,0,0,NPC
BRD-K07850148_10uM_24h,BRD-K07850148,10 uM,24 h,3,29,32,1,1,1,0,NPC
WH-4023_10uM_24h,WH-4023,10 uM,24 h,3,29,32,1,51,21,30,NPC
MT-21_10uM_24h,MT-21,10 uM,24 h,3,32,35,1,6,3,3,NPC
BRD-K36928794_10uM_24h,BRD-K36928794,10 uM,24 h,3,45,48,1,5,4,1,NPC
BRD-K78687850_10uM_24h,BRD-K78687850,10 uM,24 h,3,45,48,1,105,42,63,NPC
BRD-K84528570_10uM_24h,BRD-K84528570,10 uM,24 h,3,45,48,1,15,8,7,NPC
BRD-K96539190_10uM_24h,BRD-K96539190,10 uM,24 h,3,45,48,1,28,11,17,NPC
BRD-K55155550_10uM_24h,BRD-K55155550,10 uM,24 h,3,54,57,1,0,0,0,NPC
BRD-K63000292_10uM_24h,BRD-K63000292,10 uM,24 h,3,54,57,1,3,2,1,NPC
BRD-K39647256_10uM_24h,BRD-K39647256,10 uM,24 h,3,54,57,1,3,3,0,NPC
BRD-K16535949_10uM_24h,BRD-K16535949,10 uM,24 h,3,45,48,1,2,1,1,NPC
BRD-K19677752_10uM_24h,BRD-K19677752,10 uM,24 h,3,45,48,1,21,5,16,NPC
BRD-K08982647_10uM_24h,BRD-K08982647,10 uM,24 h,3,54,57,1,1,1,0,NPC
BRD-K28431278_10uM_24h,BRD-K28431278,10 uM,24 h,3,45,48,1,178,101,77,NPC
BRD-K55260239_10uM_24h,BRD-K55260239,10 uM,24 h,3,54,57,1,11,7,4,NPC
BRD-K77831863_10uM_24h,BRD-K77831863,10 uM,24 h,3,45,48,1,18,9,9,NPC
BRD-K91063002_10uM_24h,BRD-K91063002,10 uM,24 h,3,54,57,1,10,6,4,NPC
BRD-K43880650_10uM_24h,BRD-K43880650,10 uM,24 h,3,54,57,1,2,0,2,NPC
diaminoquinazoline_10uM_6h,diaminoquinazoline,10 uM,6 h,3,28,31,1,0,0,0,NPC
strophanthidin_10uM_24h,strophanthidin,10 uM,24 h,3,32,35,1,290,138,152,NPC
withaferin-a_10uM_24h,withaferin-a,10 uM,24 h,3,29,32,1,2,2,0,NPC
BRD-K18739469_10uM_24h,BRD-K18739469,10 uM,24 h,3,29,32,1,0,0,0,NPC
BRD-K86269644_10uM_24h,BRD-K86269644,10 uM,24 h,3,29,32,1,3,0,3,NPC
BRD-K18059238_10uM_24h,BRD-K18059238,10 uM,24 h,3,32,35,1,0,0,0,NPC
BRD-K17415526_10uM_24h,BRD-K17415526,10 uM,24 h,3,32,35,1,6,5,1,NPC
BRD-A99518825_10uM_24h,BRD-A99518825,10 uM,24 h,3,29,32,1,82,21,61,NPC
BRD-K58628167_10uM_24h,BRD-K58628167,10 uM,24 h,3,27,30,1,0,0,0,NPC
NS-1619_10uM_24h,NS-1619,10 uM,24 h,3,30,33,1,33,19,14,NPC
BRD-A13914662_10uM_24h,BRD-A13914662,10 uM,24 h,3,29,32,1,0,0,0,NPC
BRD-K16625384_10uM_24h,BRD-K16625384,10 uM,24 h,3,45,48,1,25,9,16,NPC
BRD-K78133682_10uM_24h,BRD-K78133682,10 uM,24 h,3,45,48,1,660,231,429,NPC
BRD-K73876582_10uM_24h,BRD-K73876582,10 uM,24 h,3,54,57,1,12,4,8,NPC
BRD-K40138205_10uM_24h,BRD-K40138205,10 uM,24 h,3,45,48,1,3,2,1,NPC
BRD-K01477275_10uM_24h,BRD-K01477275,10 uM,24 h,3,54,57,1,12,6,6,NPC
SA-1921085_10uM_24h,SA-1921085,10 uM,24 h,3,45,48,1,8,1,7,NPC
BRD-K29251608_10uM_24h,BRD-K29251608,10 uM,24 h,3,45,48,1,67,36,31,NPC
BRD-K15030062_10uM_24h,BRD-K15030062,10 uM,24 h,3,45,48,1,11,7,4,NPC
BRD-K03257659_10uM_24h,BRD-K03257659,10 uM,24 h,3,45,48,1,169,83,86,NPC
BRD-K41115759_10uM_24h,BRD-K41115759,10 uM,24 h,3,54,57,1,3,0,3,NPC
BRD-K17817744_10uM_24h,BRD-K17817744,10 uM,24 h,3,45,48,1,30,14,16,NPC
BRD-K02665621_10uM_24h,BRD-K02665621,10 uM,24 h,3,54,57,1,2,2,0,NPC
BRD-K91663486_10uM_24h,BRD-K91663486,10 uM,24 h,3,54,57,1,10,8,2,NPC
BRD-K20126873_10uM_24h,BRD-K20126873,10 uM,24 h,3,54,57,1,1,0,1,NPC
BRD-K77750380_10uM_24h,BRD-K77750380,10 uM,24 h,3,54,57,1,7,3,4,NPC
BRD-K95253417_10uM_24h,BRD-K95253417,10 uM,24 h,3,29,32,1,22,0,22,NPC
BRD-K08630646_10uM_24h,BRD-K08630646,10 uM,24 h,3,29,32,1,0,0,0,NPC
BRD-K90430314_10uM_24h,BRD-K90430314,10 uM,24 h,3,29,32,1,45,10,35,NPC
BRD-K40087974_10uM_24h,BRD-K40087974,10 uM,24 h,3,29,32,1,3,0,3,NPC
SA-1447005_10uM_24h,SA-1447005,10 uM,24 h,3,29,32,1,3,1,2,NPC
BRD-K68588778_10uM_24h,BRD-K68588778,10 uM,24 h,3,29,32,1,0,0,0,NPC
BRD-K79779816_10uM_24h,BRD-K79779816,10 uM,24 h,3,27,30,1,3,3,0,NPC
BRD-K95976153_10uM_24h,BRD-K95976153,10 uM,24 h,3,29,32,1,0,0,0,NPC
BRD-K65258912_10uM_24h,BRD-K65258912,10 uM,24 h,3,29,32,1,0,0,0,NPC
L-692585_10uM_24h,L-692585,10 uM,24 h,3,32,35,1,0,0,0,NPC
BRD-K53327986_10uM_24h,BRD-K53327986,10 uM,24 h,3,27,30,1,1,0,1,NPC
BRD-K82469533_10uM_24h,BRD-K82469533,10 uM,24 h,3,45,48,1,25,14,11,NPC
BRD-K79102010_10uM_24h,BRD-K79102010,10 uM,24 h,3,45,48,1,37,17,20,NPC
BRD-K69548259_10uM_24h,BRD-K69548259,10 uM,24 h,3,45,48,1,8,6,2,NPC
BRD-K80779790_10uM_24h,BRD-K80779790,10 uM,24 h,3,54,57,1,1,0,1,NPC
BRD-K69894866_10uM_24h,BRD-K69894866,10 uM,24 h,3,45,48,1,231,116,115,NPC
BRD-K80400482_10uM_24h,BRD-K80400482,10 uM,24 h,3,54,57,1,2,1,1,NPC
BRD-K77402297_10uM_24h,BRD-K77402297,10 uM,24 h,3,54,57,1,2,2,0,NPC
BRD-K76636716_10uM_24h,BRD-K76636716,10 uM,24 h,3,54,57,1,3,1,2,NPC
BRD-K15277331_10uM_24h,BRD-K15277331,10 uM,24 h,3,54,57,1,2,0,2,NPC
BRD-K36796217_10uM_24h,BRD-K36796217,10 uM,24 h,3,45,48,1,11,5,6,NPC
SU-11652_10uM_6h,SU-11652,10 uM,6 h,3,28,31,1,2,1,1,NPC
BRD-K05452595_10uM_24h,BRD-K05452595,10 uM,24 h,3,27,30,1,3,3,0,NPC
BRD-K61776140_10uM_24h,BRD-K61776140,10 uM,24 h,3,29,32,1,316,103,213,NPC
BRD-K73700643_10uM_24h,BRD-K73700643,10 uM,24 h,3,32,35,1,55,25,30,NPC
J-104129_10uM_24h,J-104129,10 uM,24 h,3,32,35,1,3,1,2,NPC
cyclazosin_10uM_24h,cyclazosin,10 uM,24 h,3,29,32,1,2,1,1,NPC
BRD-K88710727_10uM_24h,BRD-K88710727,10 uM,24 h,3,29,32,1,19,5,14,NPC
BRD-K63784565_10uM_24h,BRD-K63784565,10 uM,24 h,3,32,35,1,1,1,0,NPC
totaralolal_10uM_24h,totaralolal,10 uM,24 h,3,32,35,1,0,0,0,NPC
BRD-K25884242_10uM_24h,BRD-K25884242,10 uM,24 h,3,27,30,1,15,5,10,NPC
KM-03472SC_10uM_24h,KM-03472SC,10 uM,24 h,3,27,30,1,10,2,8,NPC
BRD-K53331454_10uM_24h,BRD-K53331454,10 uM,24 h,3,27,30,1,0,0,0,NPC
BRD-A30395175_10uM_24h,BRD-A30395175,10 uM,24 h,3,32,35,1,0,0,0,NPC
tyrphostin-51_10uM_24h,tyrphostin-51,10 uM,24 h,3,29,32,1,6,3,3,NPC
BRD-K74316684_10uM_24h,BRD-K74316684,10 uM,24 h,3,54,57,1,23,14,9,NPC
BRD-K70074151_10uM_24h,BRD-K70074151,10 uM,24 h,3,45,48,1,96,32,64,NPC
BRD-K27411973_10uM_24h,BRD-K27411973,10 uM,24 h,3,54,57,1,1,0,1,NPC
BRD-K05978741_10uM_24h,BRD-K05978741,10 uM,24 h,3,45,48,1,6,3,3,NPC
BRD-K57638192_10uM_24h,BRD-K57638192,10 uM,24 h,3,54,57,1,1,0,1,NPC
BRD-K89994146_10uM_24h,BRD-K89994146,10 uM,24 h,3,54,57,1,0,0,0,NPC
BRD-K23589333_10uM_24h,BRD-K23589333,10 uM,24 h,3,45,48,1,26,12,14,NPC
BRD-K10010115_10uM_24h,BRD-K10010115,10 uM,24 h,3,29,32,1,26,7,19,NPC
BRD-K63587518_10uM_24h,BRD-K63587518,10 uM,24 h,3,27,30,1,1,0,1,NPC
BRD-A82913781_10uM_24h,BRD-A82913781,10 uM,24 h,3,29,32,1,10,1,9,NPC
BRD-K24031526_10uM_24h,BRD-K24031526,10 uM,24 h,3,29,32,1,4,2,2,NPC
BRD-K73418978_10uM_24h,BRD-K73418978,10 uM,24 h,3,29,32,1,114,8,106,NPC
KM-00927_10uM_24h,KM-00927,10 uM,24 h,3,29,32,1,0,0,0,NPC
BRD-A39415247_10uM_24h,BRD-A39415247,10 uM,24 h,3,32,35,1,7,6,1,NPC
WAY-262611_10uM_6h,WAY-262611,10 uM,6 h,3,28,31,1,0,0,0,NPC
BRD-K12105018_10uM_24h,BRD-K12105018,10 uM,24 h,3,29,32,1,24,16,8,NPC
BRD-A13461302_10uM_24h,BRD-A13461302,10 uM,24 h,3,29,32,1,2,1,1,NPC
BRD-K06020002_10uM_24h,BRD-K06020002,10 uM,24 h,3,29,32,1,0,0,0,NPC
BRD-K03857568_10uM_24h,BRD-K03857568,10 uM,24 h,3,29,32,1,0,0,0,NPC
BRD-K54573313_10uM_24h,BRD-K54573313,10 uM,24 h,3,27,30,1,0,0,0,NPC
CL-82198_10uM_24h,CL-82198,10 uM,24 h,3,32,35,1,0,0,0,NPC
BRD-K52099002_10uM_24h,BRD-K52099002,10 uM,24 h,3,29,32,1,0,0,0,NPC
BRD-K55715339_10uM_24h,BRD-K55715339,10 uM,24 h,3,29,32,1,48,6,42,NPC
BRD-K47825575_10uM_24h,BRD-K47825575,10 uM,24 h,3,29,32,1,148,21,127,NPC
BRD-K92232855_10uM_24h,BRD-K92232855,10 uM,24 h,3,45,48,1,11,8,3,NPC
BRD-K09424864_10uM_24h,BRD-K09424864,10 uM,24 h,3,45,48,1,44,19,25,NPC
BRD-K80138901_10uM_24h,BRD-K80138901,10 uM,24 h,3,45,48,1,9,5,4,NPC
BRD-K33761091_10uM_24h,BRD-K33761091,10 uM,24 h,3,45,48,1,7,3,4,NPC
BRD-K65148580_10uM_24h,BRD-K65148580,10 uM,24 h,3,45,48,1,6,3,3,NPC
BRD-K36313546_10uM_24h,BRD-K36313546,10 uM,24 h,3,45,48,1,26,13,13,NPC
BRD-K64864583_10uM_24h,BRD-K64864583,10 uM,24 h,3,54,57,1,0,0,0,NPC
BRD-K41652832_10uM_24h,BRD-K41652832,10 uM,24 h,3,45,48,1,8,1,7,NPC
BRD-K15892609_10uM_24h,BRD-K15892609,10 uM,24 h,3,45,48,1,0,0,0,NPC
BRD-K16782389_10uM_24h,BRD-K16782389,10 uM,24 h,3,54,57,1,5,4,1,NPC
BRD-K72354054_10uM_24h,BRD-K72354054,10 uM,24 h,3,54,57,1,1,1,0,NPC
baccatin-III_10uM_24h,baccatin-III,10 uM,24 h,3,32,35,1,1,0,1,NPC
BRD-K58900438_10uM_24h,BRD-K58900438,10 uM,24 h,3,27,30,1,9,8,1,NPC
BRD-K05562558_10uM_24h,BRD-K05562558,10 uM,24 h,3,29,32,1,12,9,3,NPC
BRD-K11883928_10uM_24h,BRD-K11883928,10 uM,24 h,3,29,32,1,0,0,0,NPC
aristolochic-acid_10uM_24h,aristolochic-acid,10 uM,24 h,3,32,35,1,0,0,0,NPC
DY-44_10uM_24h,DY-44,10 uM,24 h,3,29,32,1,0,0,0,NPC
BRD-K71427192_10uM_24h,BRD-K71427192,10 uM,24 h,3,27,30,1,2,1,1,NPC
ST-4066738_10uM_24h,ST-4066738,10 uM,24 h,3,27,30,1,75,34,41,NPC
BRD-K24014699_10uM_24h,BRD-K24014699,10 uM,24 h,3,27,30,1,44,11,33,NPC
BRD-K16290432_10uM_24h,BRD-K16290432,10 uM,24 h,3,29,32,1,35,21,14,NPC
BRD-K82492171_10uM_24h,BRD-K82492171,10 uM,24 h,3,27,30,1,0,0,0,NPC
ST-019366_10uM_24h,ST-019366,10 uM,24 h,3,27,30,1,26,4,22,NPC
BRD-K21672423_10uM_24h,BRD-K21672423,10 uM,24 h,3,29,32,1,2,0,2,NPC
LY-225910_10uM_24h,LY-225910,10 uM,24 h,3,32,35,1,0,0,0,NPC
BRD-K69569876_10uM_24h,BRD-K69569876,10 uM,24 h,3,27,30,1,2,0,2,NPC
BRD-K63494246_10uM_24h,BRD-K63494246,10 uM,24 h,3,45,48,1,4,2,2,NPC
BRD-K33928422_10uM_24h,BRD-K33928422,10 uM,24 h,3,45,48,1,68,29,39,NPC
BRD-K15050703_10uM_24h,BRD-K15050703,10 uM,24 h,3,45,48,1,13,9,4,NPC
BRD-K76876037_10uM_24h,BRD-K76876037,10 uM,24 h,3,45,48,1,86,48,38,NPC
BRD-K28934562_10uM_24h,BRD-K28934562,10 uM,24 h,3,45,48,1,190,59,131,NPC
BRD-K64272762_10uM_24h,BRD-K64272762,10 uM,24 h,3,45,48,1,39,16,23,NPC
BRD-K23050218_10uM_24h,BRD-K23050218,10 uM,24 h,3,54,57,1,2,1,1,NPC
BRD-K68319707_10uM_24h,BRD-K68319707,10 uM,24 h,3,45,48,1,184,77,107,NPC
SA-1457945_10uM_24h,SA-1457945,10 uM,24 h,3,45,48,1,9,2,7,NPC
BRD-K10609180_10uM_24h,BRD-K10609180,10 uM,24 h,3,29,32,1,1,1,0,NPC
BRD-K58901278_10uM_6h,BRD-K58901278,10 uM,6 h,3,34,37,2,11,9,2,NPC
BRD-K65050353_10uM_24h,BRD-K65050353,10 uM,24 h,3,29,32,1,0,0,0,NPC
MW-STK33-2C_10uM_24h,MW-STK33-2C,10 uM,24 h,3,29,32,1,20,7,13,NPC
BRD-K41429297_10uM_24h,BRD-K41429297,10 uM,24 h,3,29,32,1,3,2,1,NPC
BAS-00594560_10uM_24h,BAS-00594560,10 uM,24 h,3,29,32,1,1,0,1,NPC
BRD-K49861754_10uM_24h,BRD-K49861754,10 uM,24 h,3,27,30,1,1,0,1,NPC
BRD-K60379529_10uM_24h,BRD-K60379529,10 uM,24 h,3,27,30,1,20,7,13,NPC
BRD-K36591038_10uM_24h,BRD-K36591038,10 uM,24 h,3,27,30,1,115,45,70,NPC
BRD-K82971429_10uM_24h,BRD-K82971429,10 uM,24 h,3,29,32,1,114,29,85,NPC
BRD-K05984448_10uM_24h,BRD-K05984448,10 uM,24 h,3,45,48,1,88,44,44,NPC
BRD-K60836534_10uM_24h,BRD-K60836534,10 uM,24 h,3,54,57,1,1,0,1,NPC
SA-84902_10uM_24h,SA-84902,10 uM,24 h,3,45,48,1,36,8,28,NPC
BRD-K83631404_10uM_24h,BRD-K83631404,10 uM,24 h,3,54,57,1,4,2,2,NPC
BRD-K46295497_10uM_24h,BRD-K46295497,10 uM,24 h,3,45,48,1,45,25,20,NPC
BRD-K42197878_10uM_24h,BRD-K42197878,10 uM,24 h,3,45,48,1,117,31,86,NPC
BRD-K83548510_10uM_24h,BRD-K83548510,10 uM,24 h,3,45,48,1,37,15,22,NPC
BRD-K50868745_10uM_24h,BRD-K50868745,10 uM,24 h,3,45,48,1,27,10,17,NPC
BRD-K42161310_10uM_24h,BRD-K42161310,10 uM,24 h,3,45,48,1,8,2,6,NPC
BRD-K61627029_10uM_24h,BRD-K61627029,10 uM,24 h,3,27,30,1,15,6,9,NPC
VU-0410183-2_10uM_24h,VU-0410183-2,10 uM,24 h,3,29,32,1,22,1,21,NPC
BRD-K68313733_10uM_24h,BRD-K68313733,10 uM,24 h,3,29,32,1,1,0,1,NPC
BRD-K99303177_10uM_24h,BRD-K99303177,10 uM,24 h,3,27,30,1,1,0,1,NPC
BRD-K27881911_10uM_24h,BRD-K27881911,10 uM,24 h,3,29,32,1,0,0,0,NPC
VU-0418946-1_10uM_24h,VU-0418946-1,10 uM,24 h,3,29,32,1,326,128,198,NPC
BRD-K48673964_10uM_24h,BRD-K48673964,10 uM,24 h,3,45,48,1,177,63,114,NPC
BRD-K63383460_10uM_24h,BRD-K63383460,10 uM,24 h,3,54,57,1,2,2,0,NPC
BRD-K36864553_10uM_24h,BRD-K36864553,10 uM,24 h,3,45,48,1,2,1,1,NPC
BRD-K76264608_10uM_24h,BRD-K76264608,10 uM,24 h,3,45,48,1,98,37,61,NPC
BRD-K31175437_10uM_24h,BRD-K31175437,10 uM,24 h,3,54,57,1,10,7,3,NPC
BRD-K95487462_10uM_24h,BRD-K95487462,10 uM,24 h,3,45,48,1,23,6,17,NPC
BRD-K69791739_10uM_24h,BRD-K69791739,10 uM,24 h,3,45,48,1,0,0,0,NPC
BRD-K20490522_10uM_24h,BRD-K20490522,10 uM,24 h,3,45,48,1,4,2,2,NPC
BRD-A27640568_10uM_24h,BRD-A27640568,10 uM,24 h,3,29,32,1,5,2,3,NPC
ST-022313_10uM_24h,ST-022313,10 uM,24 h,3,27,30,1,0,0,0,NPC
imperatorin_10uM_24h,imperatorin,10 uM,24 h,3,32,35,1,0,0,0,NPC
BRD-K81813927_10uM_24h,BRD-K81813927,10 uM,24 h,3,29,32,1,1,1,0,NPC
BRD-K59556282_10uM_24h,BRD-K59556282,10 uM,24 h,3,27,30,1,4,3,1,NPC
BRD-K59633395_10uM_24h,BRD-K59633395,10 uM,24 h,3,32,35,1,1,1,0,NPC
BRD-K30553817_10uM_6h,BRD-K30553817,10 uM,6 h,3,33,36,2,71,30,41,NPC
BRD-K28120222_10uM_24h,BRD-K28120222,10 uM,24 h,3,27,30,1,141,68,73,NPC
TG-100115_10uM_24h,TG-100115,10 uM,24 h,3,27,30,1,2,1,1,NPC
BRD-K49657628_10uM_24h,BRD-K49657628,10 uM,24 h,3,32,35,1,7,6,1,NPC
nikkomycin_10uM_24h,nikkomycin,10 uM,24 h,3,29,32,1,31,20,11,NPC
BRD-K32598858_10uM_24h,BRD-K32598858,10 uM,24 h,3,32,35,1,2,1,1,NPC
BRD-A36707673_10uM_24h,BRD-A36707673,10 uM,24 h,3,29,32,1,11,3,8,NPC
BRD-K67010098_10uM_24h,BRD-K67010098,10 uM,24 h,3,27,30,1,13,2,11,NPC
BRD-K07516181_10uM_24h,BRD-K07516181,10 uM,24 h,3,45,48,1,44,25,19,NPC
BRD-K02409808_10uM_24h,BRD-K02409808,10 uM,24 h,3,54,57,1,0,0,0,NPC
BRD-K98062050_10uM_24h,BRD-K98062050,10 uM,24 h,3,45,48,1,139,56,83,NPC
BRD-K50388960_10uM_24h,BRD-K50388960,10 uM,24 h,3,45,48,1,29,9,20,NPC
BRD-K51034923_10uM_24h,BRD-K51034923,10 uM,24 h,3,54,57,1,3,1,2,NPC
BRD-K85806228_10uM_24h,BRD-K85806228,10 uM,24 h,3,54,57,1,8,3,5,NPC
BRD-K05442673_10uM_24h,BRD-K05442673,10 uM,24 h,3,45,48,1,37,20,17,NPC
BRD-K98936959_10uM_24h,BRD-K98936959,10 uM,24 h,3,54,57,1,1,0,1,NPC
BRD-K63279176_10uM_24h,BRD-K63279176,10 uM,24 h,3,45,48,1,111,56,55,NPC
Z-36_10uM_24h,Z-36,10 uM,24 h,3,31,34,1,230,79,151,NPC
TUL-XX023_10uM_24h,TUL-XX023,10 uM,24 h,3,27,30,1,0,0,0,NPC
BRD-K28774715_10uM_24h,BRD-K28774715,10 uM,24 h,3,27,30,1,171,59,112,NPC
EMF-BCA1-64_10uM_24h,EMF-BCA1-64,10 uM,24 h,3,27,30,1,17,6,11,NPC
BRD-K39187410_10uM_24h,BRD-K39187410,10 uM,24 h,3,32,35,1,6,1,5,NPC
STK-064652_10uM_24h,STK-064652,10 uM,24 h,3,27,30,1,6,3,3,NPC
RS-I-002-6_10uM_24h,RS-I-002-6,10 uM,24 h,3,27,30,1,5,1,4,NPC
BRD-K89814851_10uM_24h,BRD-K89814851,10 uM,24 h,3,29,32,1,0,0,0,NPC
BRD-K30715099_10uM_24h,BRD-K30715099,10 uM,24 h,3,27,30,1,0,0,0,NPC
CCT-018159_10uM_24h,CCT-018159,10 uM,24 h,3,32,35,1,2,0,2,NPC
BRD-K48016779_10uM_24h,BRD-K48016779,10 uM,24 h,3,27,30,1,7,3,4,NPC
BRD-A20488704_10uM_24h,BRD-A20488704,10 uM,24 h,3,27,30,1,15,5,10,NPC
BRD-K15250199_10uM_24h,BRD-K15250199,10 uM,24 h,3,29,32,1,0,0,0,NPC
BRD-K52914903_10uM_24h,BRD-K52914903,10 uM,24 h,3,27,30,1,10,6,4,NPC
BRD-K20032655_10uM_24h,BRD-K20032655,10 uM,24 h,3,27,30,1,10,7,3,NPC
BRD-K74109131_10uM_24h,BRD-K74109131,10 uM,24 h,3,29,32,1,2,1,1,NPC
BRD-K63175663_10uM_24h,BRD-K63175663,10 uM,24 h,3,29,32,1,2,1,1,NPC
BRD-K62748479_10uM_24h,BRD-K62748479,10 uM,24 h,3,29,32,1,8,8,0,NPC
BRD-K76052538_10uM_24h,BRD-K76052538,10 uM,24 h,3,29,32,1,9,0,9,NPC
BRD-K23841751_10uM_24h,BRD-K23841751,10 uM,24 h,3,29,32,1,24,16,8,NPC
BRD-K87919739_10uM_24h,BRD-K87919739,10 uM,24 h,3,32,35,1,0,0,0,NPC
BRD-K79947405_10uM_24h,BRD-K79947405,10 uM,24 h,3,45,48,1,199,80,119,NPC
BRD-K68097207_10uM_24h,BRD-K68097207,10 uM,24 h,3,54,57,1,2,2,0,NPC
BRD-K09059649_10uM_24h,BRD-K09059649,10 uM,24 h,3,45,48,1,32,18,14,NPC
BRD-K56208365_10uM_24h,BRD-K56208365,10 uM,24 h,3,45,48,1,25,16,9,NPC
BRD-K76150323_10uM_24h,BRD-K76150323,10 uM,24 h,3,54,57,1,3,1,2,NPC
BRD-K13060097_10uM_24h,BRD-K13060097,10 uM,24 h,3,45,48,1,33,19,14,NPC
BRD-K23794511_10uM_24h,BRD-K23794511,10 uM,24 h,3,54,57,1,1,1,0,NPC
BRD-K75845944_10uM_24h,BRD-K75845944,10 uM,24 h,3,45,48,1,205,99,106,NPC
BRD-K68682056_10uM_24h,BRD-K68682056,10 uM,24 h,3,54,57,1,4,3,1,NPC
BRD-K48823327_10uM_24h,BRD-K48823327,10 uM,24 h,3,29,32,1,0,0,0,NPC
TUL-XX025TFA_10uM_24h,TUL-XX025TFA,10 uM,24 h,3,29,32,1,1,1,0,NPC
pifithrin_10uM_24h,pifithrin,10 uM,24 h,3,32,35,1,0,0,0,NPC
BRD-U04166717_10uM_24h,BRD-U04166717,10 uM,24 h,3,29,32,1,14,9,5,NPC
RAN-27_10uM_24h,RAN-27,10 uM,24 h,3,29,32,1,18,2,16,NPC
BRD-K54159704_10uM_24h,BRD-K54159704,10 uM,24 h,3,27,30,1,1,1,0,NPC
BRD-K33676730_10uM_24h,BRD-K33676730,10 uM,24 h,3,29,32,1,18,2,16,NPC
BRD-K71670746_10uM_24h,BRD-K71670746,10 uM,24 h,3,27,30,1,8,2,6,NPC
BRD-A95820578_10uM_24h,BRD-A95820578,10 uM,24 h,3,27,30,1,1,1,0,NPC
mitomycin-c_10uM_24h,mitomycin-c,10 uM,24 h,3,28,31,1,263,130,133,NPC
BRD-K66381707_10uM_24h,BRD-K66381707,10 uM,24 h,3,29,32,1,30,6,24,NPC
KM-03439_10uM_24h,KM-03439,10 uM,24 h,3,27,30,1,6,3,3,NPC
ST-001903_10uM_24h,ST-001903,10 uM,24 h,3,27,30,1,0,0,0,NPC
BRD-K00540336_10uM_24h,BRD-K00540336,10 uM,24 h,3,45,48,1,73,31,42,NPC
BRD-K49417484_10uM_24h,BRD-K49417484,10 uM,24 h,3,54,57,1,1,0,1,NPC
BRD-K55194575_10uM_24h,BRD-K55194575,10 uM,24 h,3,54,57,1,7,3,4,NPC
BRD-K87838848_10uM_24h,BRD-K87838848,10 uM,24 h,3,54,57,1,2,1,1,NPC
BRD-K70200040_10uM_24h,BRD-K70200040,10 uM,24 h,3,45,48,1,92,23,69,NPC
BRD-K92543914_10uM_24h,BRD-K92543914,10 uM,24 h,3,45,48,1,26,19,7,NPC
BRD-K85593835_10uM_24h,BRD-K85593835,10 uM,24 h,3,54,57,1,11,3,8,NPC
BRD-K01006500_10uM_24h,BRD-K01006500,10 uM,24 h,3,54,57,1,1,0,1,NPC
BRD-K30934336_10uM_24h,BRD-K30934336,10 uM,24 h,3,54,57,1,2,2,0,NPC
BRD-K91755384_10uM_24h,BRD-K91755384,10 uM,24 h,3,45,48,1,5,3,2,NPC
BRD-K16331660_10uM_24h,BRD-K16331660,10 uM,24 h,3,29,32,1,4,2,2,NPC
BRD-K88714443_10uM_24h,BRD-K88714443,10 uM,24 h,3,29,32,1,1,1,0,NPC
BRD-K89843224_10uM_24h,BRD-K89843224,10 uM,24 h,3,27,30,1,0,0,0,NPC
BRD-K45437867_10uM_24h,BRD-K45437867,10 uM,24 h,3,32,35,1,0,0,0,NPC
BRD-K72429558_10uM_24h,BRD-K72429558,10 uM,24 h,3,29,32,1,31,0,31,NPC
BRD-K48204702_10uM_24h,BRD-K48204702,10 uM,24 h,3,27,30,1,30,15,15,NPC
BRD-K62768020_10uM_24h,BRD-K62768020,10 uM,24 h,3,27,30,1,0,0,0,NPC
BRD-K62169556_10uM_24h,BRD-K62169556,10 uM,24 h,3,29,32,1,30,12,18,NPC
auraptene_10uM_24h,auraptene,10 uM,24 h,3,32,35,1,0,0,0,NPC
BRD-K27630390_10uM_24h,BRD-K27630390,10 uM,24 h,3,27,30,1,112,41,71,NPC
BRD-K37852224_10uM_24h,BRD-K37852224,10 uM,24 h,3,29,32,1,126,25,101,NPC
BRD-K19499941_10uM_24h,BRD-K19499941,10 uM,24 h,3,29,32,1,3,2,1,NPC
SSR-69071_10uM_24h,SSR-69071,10 uM,24 h,3,32,35,1,0,0,0,NPC
BRD-K25774147_10uM_24h,BRD-K25774147,10 uM,24 h,3,29,32,1,3,1,2,NPC
BRD-K04380254_10uM_24h,BRD-K04380254,10 uM,24 h,3,45,48,1,12,4,8,NPC
BRD-K96922741_10uM_24h,BRD-K96922741,10 uM,24 h,3,45,48,1,25,18,7,NPC
BRD-K85194284_10uM_24h,BRD-K85194284,10 uM,24 h,3,45,48,1,9,5,4,NPC
timosaponin_10uM_24h,timosaponin,10 uM,24 h,3,31,34,1,134,51,83,NPC
BRD-K58070753_10uM_24h,BRD-K58070753,10 uM,24 h,3,29,32,1,23,6,17,NPC
BRD-K17628612_10uM_24h,BRD-K17628612,10 uM,24 h,3,29,32,1,0,0,0,NPC
BRD-K30640165_10uM_24h,BRD-K30640165,10 uM,24 h,3,29,32,1,10,2,8,NPC
BG-FA-0953_10uM_24h,BG-FA-0953,10 uM,24 h,3,27,30,1,7,2,5,NPC
BRD-K78603557_10uM_24h,BRD-K78603557,10 uM,24 h,3,29,32,1,0,0,0,NPC
BRD-K41220170_10uM_24h,BRD-K41220170,10 uM,24 h,3,29,32,1,0,0,0,NPC
BRD-K96157570_10uM_24h,BRD-K96157570,10 uM,24 h,3,45,48,1,62,21,41,NPC
BRD-K47551852_10uM_24h,BRD-K47551852,10 uM,24 h,3,45,48,1,24,12,12,NPC
BRD-K63827443_10uM_24h,BRD-K63827443,10 uM,24 h,3,54,57,1,7,2,5,NPC
BRD-K74951051_10uM_24h,BRD-K74951051,10 uM,24 h,3,54,57,1,2,0,2,NPC
BRD-K63158888_10uM_24h,BRD-K63158888,10 uM,24 h,3,54,57,1,0,0,0,NPC
BRD-K86618560_10uM_24h,BRD-K86618560,10 uM,24 h,3,54,57,1,2,1,1,NPC
BRD-K65657366_10uM_24h,BRD-K65657366,10 uM,24 h,3,54,57,1,16,5,11,NPC
BRD-K18163752_10uM_24h,BRD-K18163752,10 uM,24 h,3,27,30,1,0,0,0,NPC
5-iodotubercidin_10uM_24h,5-iodotubercidin,10 uM,24 h,3,29,32,1,1,0,1,NPC
BRD-K11362964_10uM_24h,BRD-K11362964,10 uM,24 h,3,29,32,1,0,0,0,NPC
HA-14-1_10uM_24h,HA-14-1,10 uM,24 h,3,27,30,1,52,32,20,NPC
BRD-K52678950_10uM_24h,BRD-K52678950,10 uM,24 h,3,27,30,1,2,1,1,NPC
BRD-K58347372_10uM_24h,BRD-K58347372,10 uM,24 h,3,27,30,1,153,59,94,NPC
BRD-K13794505_10uM_24h,BRD-K13794505,10 uM,24 h,3,29,32,1,0,0,0,NPC
BRD-K98896788_10uM_24h,BRD-K98896788,10 uM,24 h,3,29,32,1,0,0,0,NPC
BRD-K25070860_10uM_24h,BRD-K25070860,10 uM,24 h,3,29,32,1,0,0,0,NPC
EI-231_10uM_24h,EI-231,10 uM,24 h,3,29,32,1,34,14,20,NPC
ST-4039884_10uM_24h,ST-4039884,10 uM,24 h,3,29,32,1,8,3,5,NPC
MW-A1-18_10uM_24h,MW-A1-18,10 uM,24 h,3,29,32,1,1,0,1,NPC
BRD-K16051505_10uM_24h,BRD-K16051505,10 uM,24 h,3,29,32,1,0,0,0,NPC
BRD-K66224104_10uM_24h,BRD-K66224104,10 uM,24 h,3,29,32,1,0,0,0,NPC
BRD-K64885524_10uM_24h,BRD-K64885524,10 uM,24 h,3,29,32,1,0,0,0,NPC
GSK-0660_10uM_24h,GSK-0660,10 uM,24 h,3,29,32,1,0,0,0,NPC
BRD-K85694079_10uM_24h,BRD-K85694079,10 uM,24 h,3,27,30,1,12,3,9,NPC
BRD-K37088230_10uM_24h,BRD-K37088230,10 uM,24 h,3,45,48,1,70,25,45,NPC
BRD-K79657514_10uM_24h,BRD-K79657514,10 uM,24 h,3,45,48,1,3,1,2,NPC
BRD-K37184875_10uM_24h,BRD-K37184875,10 uM,24 h,3,54,57,1,1,0,1,NPC
BRD-K44366812_10uM_24h,BRD-K44366812,10 uM,24 h,3,54,57,1,5,4,1,NPC
BRD-K54652275_10uM_24h,BRD-K54652275,10 uM,24 h,3,54,57,1,29,18,11,NPC
SA-1938740_10uM_24h,SA-1938740,10 uM,24 h,3,45,48,1,6,2,4,NPC
K784-3391_10uM_24h,K784-3391,10 uM,24 h,3,27,30,1,6,1,5,NPC
BRD-K48950795_10uM_24h,BRD-K48950795,10 uM,24 h,3,27,30,1,170,70,100,NPC
BRD-K73707305_10uM_24h,BRD-K73707305,10 uM,24 h,3,27,30,1,0,0,0,NPC
BRD-K11147885_10uM_24h,BRD-K11147885,10 uM,24 h,3,29,32,1,5,3,2,NPC
BRD-K43256821_10uM_24h,BRD-K43256821,10 uM,24 h,3,27,30,1,0,0,0,NPC
BRD-K70369221_10uM_24h,BRD-K70369221,10 uM,24 h,3,27,30,1,70,30,40,NPC
BRD-K16925374_10uM_24h,BRD-K16925374,10 uM,24 h,3,27,30,1,5,1,4,NPC
tyrphostin-1_10uM_24h,tyrphostin-1,10 uM,24 h,3,32,35,1,20,8,12,NPC
BRD-K47731572_10uM_24h,BRD-K47731572,10 uM,24 h,3,27,30,1,42,13,29,NPC
BRD-K41557448_10uM_24h,BRD-K41557448,10 uM,24 h,3,32,35,1,0,0,0,NPC
BRD-K93760529_10uM_24h,BRD-K93760529,10 uM,24 h,3,29,32,1,0,0,0,NPC
KM-01366_10uM_24h,KM-01366,10 uM,24 h,3,27,30,1,0,0,0,NPC
BRD-K96787835_10uM_24h,BRD-K96787835,10 uM,24 h,3,27,30,1,17,7,10,NPC
BRD-K61529775_10uM_24h,BRD-K61529775,10 uM,24 h,3,29,32,1,3,2,1,NPC
BRD-K58279162_10uM_24h,BRD-K58279162,10 uM,24 h,3,29,32,1,0,0,0,NPC
BRD-K61192129_10uM_24h,BRD-K61192129,10 uM,24 h,3,29,32,1,14,5,9,NPC
BRD-K09231502_10uM_24h,BRD-K09231502,10 uM,24 h,3,45,48,1,11,6,5,NPC
BRD-K14471942_10uM_24h,BRD-K14471942,10 uM,24 h,3,45,48,1,27,12,15,NPC
BRD-K06718821_10uM_24h,BRD-K06718821,10 uM,24 h,3,54,57,1,3,2,1,NPC
BRD-K92038420_10uM_24h,BRD-K92038420,10 uM,24 h,3,54,57,1,2,2,0,NPC
BRD-K48527688_10uM_24h,BRD-K48527688,10 uM,24 h,3,54,57,1,0,0,0,NPC
BRD-K98850601_10uM_24h,BRD-K98850601,10 uM,24 h,3,54,57,1,8,5,3,NPC
BRD-K04025047_10uM_24h,BRD-K04025047,10 uM,24 h,3,54,57,1,1,1,0,NPC
BRD-K44890999_10uM_24h,BRD-K44890999,10 uM,24 h,3,29,32,1,27,3,24,NPC
BRD-A30083233_10uM_24h,BRD-A30083233,10 uM,24 h,3,27,30,1,0,0,0,NPC
BRD-A98777808_10uM_24h,BRD-A98777808,10 uM,24 h,3,32,35,1,0,0,0,NPC
BRD-K63245238_10uM_24h,BRD-K63245238,10 uM,24 h,3,29,32,1,0,0,0,NPC
BRD-K16346331_10uM_24h,BRD-K16346331,10 uM,24 h,3,29,32,1,28,2,26,NPC
BRD-K30194621_10uM_24h,BRD-K30194621,10 uM,24 h,3,29,32,1,0,0,0,NPC
BRD-K32644160_10uM_24h,BRD-K32644160,10 uM,24 h,3,29,32,1,56,32,24,NPC
BRD-K69040870_10uM_24h,BRD-K69040870,10 uM,24 h,3,54,57,1,4,2,2,NPC
BRD-K82071478_10uM_24h,BRD-K82071478,10 uM,24 h,3,54,57,1,6,2,4,NPC
BRD-K71742078_10uM_24h,BRD-K71742078,10 uM,24 h,3,45,48,1,252,110,142,NPC
BRD-K73400194_10uM_24h,BRD-K73400194,10 uM,24 h,3,54,57,1,8,4,4,NPC
BRD-K98624380_10uM_24h,BRD-K98624380,10 uM,24 h,3,54,57,1,9,6,3,NPC
BRD-K72267874_10uM_24h,BRD-K72267874,10 uM,24 h,3,54,57,1,6,1,5,NPC
BRD-K41880142_10uM_24h,BRD-K41880142,10 uM,24 h,3,45,48,1,279,119,160,NPC
BRD-K75514176_10uM_24h,BRD-K75514176,10 uM,24 h,3,45,48,1,5,1,4,NPC
BRD-K65526065_10uM_24h,BRD-K65526065,10 uM,24 h,3,45,48,1,92,50,42,NPC
BRD-K30267135_10uM_24h,BRD-K30267135,10 uM,24 h,3,45,48,1,20,13,7,NPC
BRD-K22261046_10uM_24h,BRD-K22261046,10 uM,24 h,3,54,57,1,3,2,1,NPC
BRD-K36767861_10uM_24h,BRD-K36767861,10 uM,24 h,3,29,32,1,0,0,0,NPC
thapsigargin_10uM_6h,thapsigargin,10 uM,6 h,3,28,31,1,64,33,31,NPC
JWH-015_10uM_24h,JWH-015,10 uM,24 h,3,32,35,1,0,0,0,NPC
BRD-K26626929_10uM_24h,BRD-K26626929,10 uM,24 h,3,54,57,1,3,2,1,NPC
BRD-K56130969_10uM_24h,BRD-K56130969,10 uM,24 h,3,54,57,1,21,12,9,NPC
BRD-K01573538_10uM_24h,BRD-K01573538,10 uM,24 h,3,45,48,1,43,25,18,NPC
BRD-K74318028_10uM_24h,BRD-K74318028,10 uM,24 h,3,45,48,1,16,10,6,NPC
BRD-K03050720_10uM_24h,BRD-K03050720,10 uM,24 h,3,45,48,1,16,9,7,NPC
BRD-K82462389_10uM_24h,BRD-K82462389,10 uM,24 h,3,54,57,1,3,3,0,NPC
BRD-K51164721_10uM_24h,BRD-K51164721,10 uM,24 h,3,45,48,1,27,9,18,NPC
BRD-K29003210_10uM_24h,BRD-K29003210,10 uM,24 h,3,29,32,1,15,0,15,NPC
JNK-9L_10uM_24h,JNK-9L,10 uM,24 h,3,29,32,1,16,8,8,NPC
BRD-K41757249_10uM_24h,BRD-K41757249,10 uM,24 h,3,27,30,1,3,2,1,NPC
BRD-K07877311_10uM_24h,BRD-K07877311,10 uM,24 h,3,29,32,1,0,0,0,NPC
Ro-16-6941_10uM_24h,Ro-16-6941,10 uM,24 h,3,32,35,1,1,0,1,NPC
BRD-K80786583_10uM_24h,BRD-K80786583,10 uM,24 h,3,27,30,1,0,0,0,NPC
BRD-K37160541_10uM_24h,BRD-K37160541,10 uM,24 h,3,29,32,1,0,0,0,NPC
BRD-K27720649_10uM_24h,BRD-K27720649,10 uM,24 h,3,45,48,1,18,8,10,NPC
BRD-K27622376_10uM_24h,BRD-K27622376,10 uM,24 h,3,45,48,1,17,8,9,NPC
BRD-K99874282_10uM_24h,BRD-K99874282,10 uM,24 h,3,45,48,1,5,2,3,NPC
BRD-K34404012_10uM_24h,BRD-K34404012,10 uM,24 h,3,54,57,1,8,2,6,NPC
BRD-K18641148_10uM_24h,BRD-K18641148,10 uM,24 h,3,54,57,1,2,2,0,NPC
BRD-K55077180_10uM_24h,BRD-K55077180,10 uM,24 h,3,54,57,1,13,9,4,NPC
BRD-K09824708_10uM_24h,BRD-K09824708,10 uM,24 h,3,54,57,1,6,5,1,NPC
BRD-K63671514_10uM_24h,BRD-K63671514,10 uM,24 h,3,54,57,1,1,1,0,NPC
BRD-K00835201_10uM_24h,BRD-K00835201,10 uM,24 h,3,54,57,1,1,1,0,NPC
BRD-K83998179_10uM_24h,BRD-K83998179,10 uM,24 h,3,29,32,1,21,5,16,NPC
BRD-U87780043_10uM_24h,BRD-U87780043,10 uM,24 h,3,29,32,1,6,4,2,NPC
BRD-K58698715_10uM_24h,BRD-K58698715,10 uM,24 h,3,27,30,1,0,0,0,NPC
BRD-K42091312_10uM_24h,BRD-K42091312,10 uM,24 h,3,29,32,1,1,0,1,NPC
BRD-K30704475_10uM_24h,BRD-K30704475,10 uM,24 h,3,29,32,1,16,10,6,NPC
I-070754_10uM_24h,I-070754,10 uM,24 h,3,27,30,1,5,2,3,NPC
STOCK1S-03920_10uM_24h,STOCK1S-03920,10 uM,24 h,3,27,30,1,149,47,102,NPC
BRD-K56196992_10uM_24h,BRD-K56196992,10 uM,24 h,3,29,32,1,339,118,221,NPC
BRD-K56596360_10uM_24h,BRD-K56596360,10 uM,24 h,3,29,32,1,0,0,0,NPC
BRD-K28154645_10uM_24h,BRD-K28154645,10 uM,24 h,3,45,48,1,22,9,13,NPC
BRD-K21913257_10uM_24h,BRD-K21913257,10 uM,24 h,3,45,48,1,5,2,3,NPC
BRD-K49687221_10uM_24h,BRD-K49687221,10 uM,24 h,3,54,57,1,12,9,3,NPC
BRD-K49807497_10uM_24h,BRD-K49807497,10 uM,24 h,3,29,32,1,0,0,0,NPC
BRD-K54331210_10uM_24h,BRD-K54331210,10 uM,24 h,3,27,30,1,184,82,102,NPC
BRD-K31542390_10uM_24h,BRD-K31542390,10 uM,24 h,3,32,35,1,21,13,8,NPC
BRD-K72505034_10uM_24h,BRD-K72505034,10 uM,24 h,3,29,32,1,0,0,0,NPC
BRD-K34387287_10uM_24h,BRD-K34387287,10 uM,24 h,3,29,32,1,4,3,1,NPC
ST-4028268_10uM_24h,ST-4028268,10 uM,24 h,3,27,30,1,6,3,3,NPC
BRD-U32365159_10uM_24h,BRD-U32365159,10 uM,24 h,3,29,32,1,71,26,45,NPC
BRD-K55878534_10uM_24h,BRD-K55878534,10 uM,24 h,3,54,57,1,1,0,1,NPC
BRD-K71195237_10uM_24h,BRD-K71195237,10 uM,24 h,3,45,48,1,73,31,42,NPC
BRD-K35188965_10uM_24h,BRD-K35188965,10 uM,24 h,3,45,48,1,2,2,0,NPC
BRD-K59472190_10uM_24h,BRD-K59472190,10 uM,24 h,3,45,48,1,13,3,10,NPC
BRD-K78018080_10uM_24h,BRD-K78018080,10 uM,24 h,3,54,57,1,6,2,4,NPC
BRD-K75843415_10uM_24h,BRD-K75843415,10 uM,24 h,3,45,48,1,22,10,12,NPC
WAY-262611_10uM_24h,WAY-262611,10 uM,24 h,3,31,34,1,161,47,114,NPC
BRD-K70161581_10uM_24h,BRD-K70161581,10 uM,24 h,3,29,32,1,2,0,2,NPC
3-matida_10uM_24h,3-matida,10 uM,24 h,3,32,35,1,0,0,0,NPC
BRD-K51731619_10uM_24h,BRD-K51731619,10 uM,24 h,3,27,30,1,18,12,6,NPC
BRD-K91987625_10uM_24h,BRD-K91987625,10 uM,24 h,3,29,32,1,79,25,54,NPC
RAN-14A_10uM_24h,RAN-14A,10 uM,24 h,3,29,32,1,0,0,0,NPC
BRD-K88708949_10uM_24h,BRD-K88708949,10 uM,24 h,3,29,32,1,19,12,7,NPC
BRD-K55536701_10uM_24h,BRD-K55536701,10 uM,24 h,3,27,30,1,7,3,4,NPC
BRD-K70875408_10uM_24h,BRD-K70875408,10 uM,24 h,3,45,48,1,192,65,127,NPC
BRD-K79112806_10uM_24h,BRD-K79112806,10 uM,24 h,3,45,48,1,3,2,1,NPC
BRD-K68326515_10uM_24h,BRD-K68326515,10 uM,24 h,3,54,57,1,14,6,8,NPC
BRD-K18972207_10uM_24h,BRD-K18972207,10 uM,24 h,3,45,48,1,138,42,96,NPC
BRD-K87536251_10uM_24h,BRD-K87536251,10 uM,24 h,3,54,57,1,0,0,0,NPC
BRD-K11795542_10uM_24h,BRD-K11795542,10 uM,24 h,3,27,30,1,32,4,28,NPC
BRD-K78559095_10uM_24h,BRD-K78559095,10 uM,24 h,3,29,32,1,26,23,3,NPC
RAN-02_10uM_24h,RAN-02,10 uM,24 h,3,29,32,1,0,0,0,NPC
JFD02227_10uM_24h,JFD02227,10 uM,24 h,3,29,32,1,0,0,0,NPC
SU-11274_10uM_24h,SU-11274,10 uM,24 h,3,29,32,1,1,0,1,NPC
BRD-K25979535_10uM_24h,BRD-K25979535,10 uM,24 h,3,29,32,1,27,16,11,NPC
BRD-K26048285_10uM_24h,BRD-K26048285,10 uM,24 h,3,27,30,1,155,83,72,NPC
BRD-K07061353_10uM_24h,BRD-K07061353,10 uM,24 h,3,29,32,1,0,0,0,NPC
BRD-U74615290_10uM_24h,BRD-U74615290,10 uM,24 h,3,29,32,1,9,3,6,NPC
BRD-K39687892_10uM_24h,BRD-K39687892,10 uM,24 h,3,29,32,1,0,0,0,NPC
BRD-K13872703_10uM_24h,BRD-K13872703,10 uM,24 h,3,32,35,1,0,0,0,NPC
SA-1460224_10uM_24h,SA-1460224,10 uM,24 h,3,54,57,1,2,2,0,NPC
BRD-M32778103_10uM_24h,BRD-M32778103,10 uM,24 h,3,45,48,1,42,19,23,NPC
BRD-K63903580_10uM_24h,BRD-K63903580,10 uM,24 h,3,54,57,1,1,1,0,NPC
BRD-K74436011_10uM_24h,BRD-K74436011,10 uM,24 h,3,54,57,1,0,0,0,NPC
BRD-K80579245_10uM_24h,BRD-K80579245,10 uM,24 h,3,54,57,1,0,0,0,NPC
BRD-K63220166_10uM_24h,BRD-K63220166,10 uM,24 h,3,29,32,1,0,0,0,NPC
ochratoxin-a_10uM_24h,ochratoxin-a,10 uM,24 h,3,29,32,1,70,19,51,NPC
eriodictyol_10uM_24h,eriodictyol,10 uM,24 h,3,32,35,1,1,1,0,NPC
BRD-K05520923_10uM_24h,BRD-K05520923,10 uM,24 h,3,27,30,1,16,6,10,NPC
BRD-A30455275_10uM_24h,BRD-A30455275,10 uM,24 h,3,29,32,1,0,0,0,NPC
BRD-K00390580_10uM_24h,BRD-K00390580,10 uM,24 h,3,27,30,1,4,2,2,NPC
docosatrienoic-acid_10uM_24h,docosatrienoic-acid,10 uM,24 h,3,32,35,1,0,0,0,NPC
BRD-K25050358_10uM_24h,BRD-K25050358,10 uM,24 h,3,54,57,1,16,5,11,NPC
BRD-K52225919_10uM_24h,BRD-K52225919,10 uM,24 h,3,45,48,1,17,5,12,NPC
BRD-K42620042_10uM_24h,BRD-K42620042,10 uM,24 h,3,54,57,1,3,2,1,NPC
BRD-K45466167_10uM_24h,BRD-K45466167,10 uM,24 h,3,54,57,1,5,4,1,NPC
BRD-K77014406_10uM_24h,BRD-K77014406,10 uM,24 h,3,29,32,1,4,1,3,NPC
UGISS-186_10uM_24h,UGISS-186,10 uM,24 h,3,29,32,1,29,0,29,NPC
heraclenol_10uM_24h,heraclenol,10 uM,24 h,3,27,30,1,32,13,19,NPC
epothilone-a_10uM_24h,epothilone-a,10 uM,24 h,3,27,30,1,309,119,190,NPC
VU-0418933-1_10uM_24h,VU-0418933-1,10 uM,24 h,3,29,32,1,64,36,28,NPC
BRD-A95944315_10uM_24h,BRD-A95944315,10 uM,24 h,3,27,30,1,6,2,4,NPC
ST-4034902_10uM_24h,ST-4034902,10 uM,24 h,3,27,30,1,3,1,2,NPC
SA-1459008_10uM_24h,SA-1459008,10 uM,24 h,3,45,48,1,154,37,117,NPC
BRD-K86522396_10uM_24h,BRD-K86522396,10 uM,24 h,3,45,48,1,109,29,80,NPC
BRD-K67498554_10uM_24h,BRD-K67498554,10 uM,24 h,3,54,57,1,0,0,0,NPC
BRD-K73008154_10uM_24h,BRD-K73008154,10 uM,24 h,3,45,48,1,32,16,16,NPC
BRD-K39799535_10uM_24h,BRD-K39799535,10 uM,24 h,3,54,57,1,0,0,0,NPC
BRD-K49111930_10uM_24h,BRD-K49111930,10 uM,24 h,3,45,48,1,85,32,53,NPC
BRD-K66775134_10uM_24h,BRD-K66775134,10 uM,24 h,3,54,57,1,2,1,1,NPC
BRD-K81210389_10uM_24h,BRD-K81210389,10 uM,24 h,3,54,57,1,9,4,5,NPC
BRD-A04172077_10uM_24h,BRD-A04172077,10 uM,24 h,3,29,32,1,2,2,0,NPC
BRD-K76882924_10uM_24h,BRD-K76882924,10 uM,24 h,3,29,32,1,0,0,0,NPC
BRD-K75081836_10uM_24h,BRD-K75081836,10 uM,24 h,3,29,32,1,11,5,6,NPC
ST-4029573_10uM_24h,ST-4029573,10 uM,24 h,3,27,30,1,140,49,91,NPC
BRD-K09977233_10uM_24h,BRD-K09977233,10 uM,24 h,3,29,32,1,6,4,2,NPC
STK-661558_10uM_24h,STK-661558,10 uM,24 h,3,29,32,1,61,25,36,NPC
KB188-III-56_10uM_24h,KB188-III-56,10 uM,24 h,3,27,30,1,3,1,2,NPC
BRD-K69501658_10uM_24h,BRD-K69501658,10 uM,24 h,3,29,32,1,39,8,31,NPC
BRD-K44494044_10uM_24h,BRD-K44494044,10 uM,24 h,3,29,32,1,14,7,7,NPC
BRD-K23564937_10uM_24h,BRD-K23564937,10 uM,24 h,3,54,57,1,13,3,10,NPC
BRD-K96552587_10uM_24h,BRD-K96552587,10 uM,24 h,3,45,48,1,64,20,44,NPC
BRD-K28649955_10uM_24h,BRD-K28649955,10 uM,24 h,3,54,57,1,2,1,1,NPC
6-hydroxytropinone_10uM_24h,6-hydroxytropinone,10 uM,24 h,3,32,35,1,1,1,0,NPC
BRD-K97019106_10uM_24h,BRD-K97019106,10 uM,24 h,3,32,35,1,1,1,0,NPC
TUL-XVIII076_10uM_24h,TUL-XVIII076,10 uM,24 h,3,29,32,1,2,0,2,NPC
BRD-K98004941_10uM_24h,BRD-K98004941,10 uM,24 h,3,29,32,1,0,0,0,NPC
BRD-K70524666_10uM_24h,BRD-K70524666,10 uM,24 h,3,29,32,1,0,0,0,NPC
BIX-01338_10uM_24h,BIX-01338,10 uM,24 h,3,29,32,1,0,0,0,NPC
epothilone_10uM_24h,epothilone,10 uM,24 h,3,29,32,1,11,2,9,NPC
BRD-K41878610_10uM_24h,BRD-K41878610,10 uM,24 h,3,54,57,1,13,1,12,NPC
BRD-K18814836_10uM_24h,BRD-K18814836,10 uM,24 h,3,54,57,1,0,0,0,NPC
BRD-K27865298_10uM_24h,BRD-K27865298,10 uM,24 h,3,54,57,1,8,4,4,NPC
BRD-K43253317_10uM_24h,BRD-K43253317,10 uM,24 h,3,54,57,1,0,0,0,NPC
MW-A1-6_10uM_24h,MW-A1-6,10 uM,24 h,3,29,32,1,1,1,0,NPC
HU-211_10uM_24h,HU-211,10 uM,24 h,3,29,32,1,487,194,293,NPC
BRD-A50388635_10uM_24h,BRD-A50388635,10 uM,24 h,3,29,32,1,2,1,1,NPC
BRD-K82837433_10uM_24h,BRD-K82837433,10 uM,24 h,3,29,32,1,10,2,8,NPC
NP-010914_10uM_24h,NP-010914,10 uM,24 h,3,27,30,1,102,45,57,NPC
BRD-K57019930_10uM_24h,BRD-K57019930,10 uM,24 h,3,27,30,1,2,0,2,NPC
BRD-K36031023_10uM_24h,BRD-K36031023,10 uM,24 h,3,29,32,1,0,0,0,NPC
ionomycin_10uM_24h,ionomycin,10 uM,24 h,3,31,34,1,253,94,159,NPC
BRD-K84855052_10uM_24h,BRD-K84855052,10 uM,24 h,3,29,32,1,9,2,7,NPC
I-303059_10uM_24h,I-303059,10 uM,24 h,3,29,32,1,2,2,0,NPC
BRD-A93015352_10uM_24h,BRD-A93015352,10 uM,24 h,3,27,30,1,0,0,0,NPC
BRD-A14178283_10uM_24h,BRD-A14178283,10 uM,24 h,3,27,30,1,7,0,7,NPC
BRD-K24656059_10uM_24h,BRD-K24656059,10 uM,24 h,3,45,48,1,254,72,182,NPC
BRD-K39504007_10uM_24h,BRD-K39504007,10 uM,24 h,3,45,48,1,51,19,32,NPC
BRD-K11977286_10uM_24h,BRD-K11977286,10 uM,24 h,3,54,57,1,7,3,4,NPC
BRD-K87125912_10uM_24h,BRD-K87125912,10 uM,24 h,3,54,57,1,167,73,94,NPC
BRD-K97758158_10uM_24h,BRD-K97758158,10 uM,24 h,3,54,57,1,0,0,0,NPC
BRD-K98945308_10uM_24h,BRD-K98945308,10 uM,24 h,3,54,57,1,41,17,24,NPC
BRD-K92993117_10uM_24h,BRD-K92993117,10 uM,24 h,3,54,57,1,2,1,1,NPC
BRD-K91730835_10uM_24h,BRD-K91730835,10 uM,24 h,3,54,57,1,4,1,3,NPC
BRD-K94193354_10uM_24h,BRD-K94193354,10 uM,24 h,3,54,57,1,0,0,0,NPC
BRD-K50384076_10uM_24h,BRD-K50384076,10 uM,24 h,3,32,35,1,0,0,0,NPC
BRD-K75418381_10uM_24h,BRD-K75418381,10 uM,24 h,3,27,30,1,4,2,2,NPC
BRD-K73238422_10uM_24h,BRD-K73238422,10 uM,24 h,3,29,32,1,1,1,0,NPC
BRD-K41668190_10uM_24h,BRD-K41668190,10 uM,24 h,3,29,32,1,0,0,0,NPC
BRD-A56800788_10uM_24h,BRD-A56800788,10 uM,24 h,3,27,30,1,1,0,1,NPC
BRD-U01690642_10uM_24h,BRD-U01690642,10 uM,24 h,3,29,32,1,2,1,1,NPC
calmidazolium_10uM_24h,calmidazolium,10 uM,24 h,3,29,32,1,8,5,3,NPC
SA-103006_10uM_24h,SA-103006,10 uM,24 h,3,27,30,1,0,0,0,NPC
BRD-K41652870_10uM_24h,BRD-K41652870,10 uM,24 h,3,29,32,1,0,0,0,NPC
BRD-K36333904_10uM_24h,BRD-K36333904,10 uM,24 h,3,54,57,1,32,23,9,NPC
BRD-K96697180_10uM_24h,BRD-K96697180,10 uM,24 h,3,45,48,1,27,13,14,NPC
BRD-K03641022_10uM_24h,BRD-K03641022,10 uM,24 h,3,45,48,1,3,1,2,NPC
BRD-K76425827_10uM_24h,BRD-K76425827,10 uM,24 h,3,29,32,1,26,1,25,NPC
BRD-K85123403_10uM_24h,BRD-K85123403,10 uM,24 h,3,29,32,1,4,0,4,NPC
BRD-K45842176_10uM_24h,BRD-K45842176,10 uM,24 h,3,29,32,1,54,8,46,NPC
BRD-K52640952_10uM_24h,BRD-K52640952,10 uM,24 h,3,27,30,1,17,10,7,NPC
BRD-K31851742_10uM_24h,BRD-K31851742,10 uM,24 h,3,29,32,1,0,0,0,NPC
BRD-K50360938_10uM_24h,BRD-K50360938,10 uM,24 h,3,27,30,1,37,15,22,NPC
BRD-K46836114_10uM_24h,BRD-K46836114,10 uM,24 h,3,32,35,1,2,2,0,NPC
BRD-K33396764_10uM_24h,BRD-K33396764,10 uM,24 h,3,30,33,1,0,0,0,NPC
BRD-K39092862_10uM_24h,BRD-K39092862,10 uM,24 h,3,45,48,1,7,4,3,NPC
BRD-K34230554_10uM_24h,BRD-K34230554,10 uM,24 h,3,54,57,1,4,1,3,NPC
BRD-K84024786_10uM_24h,BRD-K84024786,10 uM,24 h,3,54,57,1,1,1,0,NPC
BRD-K98471960_10uM_24h,BRD-K98471960,10 uM,24 h,3,54,57,1,0,0,0,NPC
BRD-K65373229_10uM_24h,BRD-K65373229,10 uM,24 h,3,54,57,1,0,0,0,NPC
NSC-94258_10uM_24h,NSC-94258,10 uM,24 h,3,32,35,1,0,0,0,NPC
tetrahydropalmatine_10uM_24h,tetrahydropalmatine,10 uM,24 h,3,32,35,1,0,0,0,NPC
BRD-A70591769_10uM_24h,BRD-A70591769,10 uM,24 h,3,27,30,1,2,1,1,NPC
BRD-K96704748_10uM_24h,BRD-K96704748,10 uM,24 h,3,27,30,1,2,1,1,NPC
BRD-K10087454_10uM_24h,BRD-K10087454,10 uM,24 h,3,45,48,1,21,12,9,NPC
ML-4054_10uM_24h,ML-4054,10 uM,24 h,3,29,32,1,0,0,0,NPC
guanabenz_10uM_24h,guanabenz,10 uM,24 h,3,32,35,1,0,0,0,NPC
ST-4029010_10uM_24h,ST-4029010,10 uM,24 h,3,27,30,1,3,2,1,NPC
RAN-30_10uM_24h,RAN-30,10 uM,24 h,3,29,32,1,0,0,0,NPC
BRD-K14328427_10uM_24h,BRD-K14328427,10 uM,24 h,3,27,30,1,1,1,0,NPC
BRD-K81795824_10uM_24h,BRD-K81795824,10 uM,24 h,3,29,32,1,28,24,4,NPC
BRD-K70086257_10uM_24h,BRD-K70086257,10 uM,24 h,3,27,30,1,0,0,0,NPC
CAY-10578_10uM_24h,CAY-10578,10 uM,24 h,3,29,32,1,0,0,0,NPC
BRD-K73276569_10uM_24h,BRD-K73276569,10 uM,24 h,3,54,57,1,24,7,17,NPC
BRD-K91461129_10uM_24h,BRD-K91461129,10 uM,24 h,3,54,57,1,0,0,0,NPC
GP-1a_10uM_24h,GP-1a,10 uM,24 h,3,32,35,1,0,0,0,NPC
BRD-K11841836_10uM_24h,BRD-K11841836,10 uM,24 h,3,29,32,1,2,2,0,NPC
BRD-K53592093_10uM_24h,BRD-K53592093,10 uM,24 h,3,27,30,1,54,22,32,NPC
BRD-K88542532_10uM_24h,BRD-K88542532,10 uM,24 h,3,27,30,1,33,5,28,NPC
BRD-K70711508_10uM_24h,BRD-K70711508,10 uM,24 h,3,45,48,1,12,6,6,NPC
BRD-K12683703_10uM_24h,BRD-K12683703,10 uM,24 h,3,45,48,1,12,10,2,NPC
BRD-K70697816_10uM_24h,BRD-K70697816,10 uM,24 h,3,45,48,1,38,22,16,NPC
BRD-K97972722_10uM_24h,BRD-K97972722,10 uM,24 h,3,54,57,1,6,4,2,NPC
BRD-K88822846_10uM_24h,BRD-K88822846,10 uM,24 h,3,45,48,1,83,50,33,NPC
BRD-K16180117_10uM_24h,BRD-K16180117,10 uM,24 h,3,27,30,1,6,2,4,NPC
MD-040_10uM_24h,MD-040,10 uM,24 h,3,27,30,1,3,2,1,NPC
BRD-K57926513_10uM_24h,BRD-K57926513,10 uM,24 h,3,29,32,1,3,1,2,NPC
BRD-K84803513_10uM_24h,BRD-K84803513,10 uM,24 h,3,27,30,1,0,0,0,NPC
BRD-K71935468_10uM_24h,BRD-K71935468,10 uM,24 h,3,29,32,1,66,15,51,NPC
BRD-K11169037_10uM_24h,BRD-K11169037,10 uM,24 h,3,45,48,1,127,35,92,NPC
desmethyl-DASB_10uM_24h,desmethyl-DASB,10 uM,24 h,3,34,37,2,0,0,0,NPC
catechin_10uM_24h,catechin,10 uM,24 h,3,32,35,1,0,0,0,NPC
enobosarm_10uM_24h,enobosarm,10 uM,24 h,3,27,30,1,2,1,1,NPC
BRD-K58223721_10uM_24h,BRD-K58223721,10 uM,24 h,3,32,35,1,0,0,0,NPC
BRD-K90610876_10uM_24h,BRD-K90610876,10 uM,24 h,3,32,35,1,1,1,0,NPC
BRD-K83620635_10uM_24h,BRD-K83620635,10 uM,24 h,3,27,30,1,247,108,139,NPC
BRD-A89067742_10uM_24h,BRD-A89067742,10 uM,24 h,3,29,32,1,0,0,0,NPC
BRD-A83402799_10uM_24h,BRD-A83402799,10 uM,24 h,3,27,30,1,1,0,1,NPC
BRD-K38024502_10uM_24h,BRD-K38024502,10 uM,24 h,3,45,48,1,130,38,92,NPC
BRD-K44242139_10uM_24h,BRD-K44242139,10 uM,24 h,3,54,57,1,27,21,6,NPC
BRD-K61359235_10uM_24h,BRD-K61359235,10 uM,24 h,3,27,30,1,9,3,6,NPC
XMD-1150_10uM_24h,XMD-1150,10 uM,24 h,3,29,32,1,0,0,0,NPC
BRD-K79758054_10uM_24h,BRD-K79758054,10 uM,24 h,3,45,48,1,27,9,18,NPC
BRD-K82096551_10uM_24h,BRD-K82096551,10 uM,24 h,3,45,48,1,14,7,7,NPC
BRD-K10211010_10uM_24h,BRD-K10211010,10 uM,24 h,3,54,57,1,5,2,3,NPC
BRD-K16034108_10uM_24h,BRD-K16034108,10 uM,24 h,3,45,48,1,14,5,9,NPC
BRD-K53214709_10uM_24h,BRD-K53214709,10 uM,24 h,3,27,30,1,7,2,5,NPC
BRD-A37656721_10uM_24h,BRD-A37656721,10 uM,24 h,3,29,32,1,0,0,0,NPC
BRD-A68721828_10uM_24h,BRD-A68721828,10 uM,24 h,3,29,32,1,3,2,1,NPC
BRD-K33926001_10uM_24h,BRD-K33926001,10 uM,24 h,3,29,32,1,0,0,0,NPC
BRD-K87252271_10uM_24h,BRD-K87252271,10 uM,24 h,3,45,48,1,13,7,6,NPC
BRD-K73517272_10uM_24h,BRD-K73517272,10 uM,24 h,3,45,48,1,3,3,0,NPC
BRD-K21387011_10uM_24h,BRD-K21387011,10 uM,24 h,3,45,48,1,17,6,11,NPC
BRD-K54335715_10uM_24h,BRD-K54335715,10 uM,24 h,3,54,57,1,10,0,10,NPC
BRD-K88329126_10uM_24h,BRD-K88329126,10 uM,24 h,3,32,35,1,1,1,0,NPC
BRD-K11981252_10uM_24h,BRD-K11981252,10 uM,24 h,3,29,32,1,5,0,5,NPC
BRD-K14842454_10uM_24h,BRD-K14842454,10 uM,24 h,3,29,32,1,0,0,0,NPC
BRD-K47764688_10uM_24h,BRD-K47764688,10 uM,24 h,3,27,30,1,30,14,16,NPC
BRD-K33164466_10uM_24h,BRD-K33164466,10 uM,24 h,3,27,30,1,3,0,3,NPC
BRD-K20197338_10uM_24h,BRD-K20197338,10 uM,24 h,3,54,57,1,3,2,1,NPC
SA-1456751_10uM_24h,SA-1456751,10 uM,24 h,3,54,57,1,13,4,9,NPC
BRD-K28138218_10uM_24h,BRD-K28138218,10 uM,24 h,3,54,57,1,9,2,7,NPC
BRD-K41889859_10uM_24h,BRD-K41889859,10 uM,24 h,3,54,57,1,5,2,3,NPC
BRD-K98036459_10uM_24h,BRD-K98036459,10 uM,24 h,3,54,57,1,2,1,1,NPC
BRD-K14415573_10uM_24h,BRD-K14415573,10 uM,24 h,3,54,57,1,2,0,2,NPC
lavendustin-a_10uM_24h,lavendustin-a,10 uM,24 h,3,32,35,1,1,1,0,NPC
SJB-AF-2_10uM_24h,SJB-AF-2,10 uM,24 h,3,29,32,1,0,0,0,NPC
BRD-K06652922_10uM_24h,BRD-K06652922,10 uM,24 h,3,29,32,1,21,4,17,NPC
BRD-K10554164_10uM_24h,BRD-K10554164,10 uM,24 h,3,29,32,1,118,33,85,NPC
BRD-K73888531_10uM_24h,BRD-K73888531,10 uM,24 h,3,29,32,1,0,0,0,NPC
FCCP_10uM_24h,FCCP,10 uM,24 h,3,26,29,1,503,194,309,NPC
BRD-K81218586_10uM_24h,BRD-K81218586,10 uM,24 h,3,54,57,1,2,2,0,NPC
BRD-K44261129_10uM_24h,BRD-K44261129,10 uM,24 h,3,45,48,1,26,9,17,NPC
SA-1463810_10uM_24h,SA-1463810,10 uM,24 h,3,54,57,1,1,1,0,NPC
BRD-K96396151_10uM_24h,BRD-K96396151,10 uM,24 h,3,45,48,1,53,24,29,NPC
BRD-K25828886_10uM_24h,BRD-K25828886,10 uM,24 h,3,54,57,1,4,1,3,NPC
BRD-A70879086_10uM_24h,BRD-A70879086,10 uM,24 h,3,27,30,1,1,1,0,NPC
BRD-K06071925_10uM_24h,BRD-K06071925,10 uM,24 h,3,27,30,1,38,13,25,NPC
BRD-K43069600_10uM_24h,BRD-K43069600,10 uM,24 h,3,29,32,1,63,3,60,NPC
BRD-K92489476_10uM_24h,BRD-K92489476,10 uM,24 h,3,27,30,1,0,0,0,NPC
BRD-K74446951_10uM_24h,BRD-K74446951,10 uM,24 h,3,45,48,1,96,30,66,NPC
SD-6-035-B3_10uM_24h,SD-6-035-B3,10 uM,24 h,3,45,48,1,41,18,23,NPC
BRD-K94740841_10uM_24h,BRD-K94740841,10 uM,24 h,3,54,57,1,5,2,3,NPC
BRD-K67787765_10uM_24h,BRD-K67787765,10 uM,24 h,3,45,48,1,108,49,59,NPC
BRD-K68191033_10uM_24h,BRD-K68191033,10 uM,24 h,3,29,32,1,0,0,0,NPC
BRD-K46171503_10uM_24h,BRD-K46171503,10 uM,24 h,3,27,30,1,79,16,63,NPC
LM-1685_10uM_24h,LM-1685,10 uM,24 h,3,29,32,1,1,1,0,NPC
BRD-K32480606_10uM_24h,BRD-K32480606,10 uM,24 h,3,32,35,1,0,0,0,NPC
BRD-K09329774_10uM_24h,BRD-K09329774,10 uM,24 h,3,45,48,1,16,6,10,NPC
BRD-K46707636_10uM_24h,BRD-K46707636,10 uM,24 h,3,45,48,1,5,1,4,NPC
BRD-K01497355_10uM_24h,BRD-K01497355,10 uM,24 h,3,54,57,1,4,2,2,NPC
BRD-K96167523_10uM_24h,BRD-K96167523,10 uM,24 h,3,27,30,1,1,0,1,NPC
ST-4029655_10uM_24h,ST-4029655,10 uM,24 h,3,27,30,1,38,18,20,NPC
BRD-K17139610_10uM_24h,BRD-K17139610,10 uM,24 h,3,45,48,1,55,16,39,NPC
BRD-K18300217_10uM_24h,BRD-K18300217,10 uM,24 h,3,45,48,1,47,13,34,NPC
AG-370_10uM_24h,AG-370,10 uM,24 h,3,32,35,1,0,0,0,NPC
BRD-K48924007_10uM_24h,BRD-K48924007,10 uM,24 h,3,29,32,1,0,0,0,NPC
P-1075_10uM_24h,P-1075,10 uM,24 h,3,32,35,1,0,0,0,NPC
oligomycin-a_10uM_24h,oligomycin-a,10 uM,24 h,3,27,30,1,71,17,54,NPC
BRD-K22052171_10uM_24h,BRD-K22052171,10 uM,24 h,3,54,57,1,10,4,6,NPC
BRD-K13559922_10uM_24h,BRD-K13559922,10 uM,24 h,3,54,57,1,35,23,12,NPC
BRD-K46961308_10uM_24h,BRD-K46961308,10 uM,24 h,3,27,30,1,5,4,1,NPC
BRD-K23657553_10uM_24h,BRD-K23657553,10 uM,24 h,3,27,30,1,50,20,30,NPC
BRD-K08438429_10uM_24h,BRD-K08438429,10 uM,24 h,3,32,35,1,0,0,0,NPC
ST-208960_10uM_24h,ST-208960,10 uM,24 h,3,27,30,1,0,0,0,NPC
BRD-K70947604_10uM_24h,BRD-K70947604,10 uM,24 h,3,29,32,1,20,3,17,NPC
RAN-05_10uM_24h,RAN-05,10 uM,24 h,3,29,32,1,1,1,0,NPC
BRD-A01960364_10uM_24h,BRD-A01960364,10 uM,24 h,3,29,32,1,1,1,0,NPC
endecaphyllin-x_10uM_24h,endecaphyllin-x,10 uM,24 h,3,31,34,1,243,92,151,NPC
BRD-K36232729_10uM_24h,BRD-K36232729,10 uM,24 h,3,45,48,1,6,2,4,NPC
BRD-K20332840_10uM_24h,BRD-K20332840,10 uM,24 h,3,54,57,1,0,0,0,NPC
BRD-K95786246_10uM_24h,BRD-K95786246,10 uM,24 h,3,54,57,1,6,1,5,NPC
SU-1498_10uM_24h,SU-1498,10 uM,24 h,3,31,34,1,5,4,1,NPC
BRD-K08307026_10uM_24h,BRD-K08307026,10 uM,24 h,3,29,32,1,259,129,130,NPC
BAY-59-3074_10uM_24h,BAY-59-3074,10 uM,24 h,3,30,33,1,43,34,9,NPC
BRD-K26257340_10uM_24h,BRD-K26257340,10 uM,24 h,3,29,32,1,0,0,0,NPC
BRD-K18542345_10uM_24h,BRD-K18542345,10 uM,24 h,3,45,48,1,14,6,8,NPC
BRD-K09640010_10uM_24h,BRD-K09640010,10 uM,24 h,3,54,57,1,5,3,2,NPC
BRD-K66902379_10uM_24h,BRD-K66902379,10 uM,24 h,3,29,32,1,4,2,2,NPC
prostaglandin-a1_10uM_24h,prostaglandin-a1,10 uM,24 h,3,32,35,1,0,0,0,NPC
BRD-K00486725_10uM_24h,BRD-K00486725,10 uM,24 h,3,29,32,1,0,0,0,NPC
BRD-K28789065_10uM_24h,BRD-K28789065,10 uM,24 h,3,27,30,1,15,2,13,NPC
S-206352_10uM_24h,S-206352,10 uM,24 h,3,27,30,1,34,9,25,NPC
BRD-K50659736_10uM_24h,BRD-K50659736,10 uM,24 h,3,29,32,1,0,0,0,NPC
BRD-K70983703_10uM_24h,BRD-K70983703,10 uM,24 h,3,54,57,1,1,0,1,NPC
BRD-K15935695_10uM_24h,BRD-K15935695,10 uM,24 h,3,45,48,1,20,7,13,NPC
BRD-K88735704_10uM_24h,BRD-K88735704,10 uM,24 h,3,29,32,1,6,1,5,NPC
BRD-K85549762_10uM_24h,BRD-K85549762,10 uM,24 h,3,45,48,1,60,26,34,NPC
BRD-K30126976_10uM_24h,BRD-K30126976,10 uM,24 h,3,45,48,1,23,10,13,NPC
BRD-K80171496_10uM_24h,BRD-K80171496,10 uM,24 h,3,54,57,1,1,1,0,NPC
BRD-K14395638_10uM_24h,BRD-K14395638,10 uM,24 h,3,27,30,1,1,0,1,NPC
BRD-K90090262_10uM_24h,BRD-K90090262,10 uM,24 h,3,29,32,1,24,4,20,NPC
BRD-K06817181_10uM_24h,BRD-K06817181,10 uM,24 h,3,32,35,1,1,1,0,NPC
BRD-K96041907_10uM_24h,BRD-K96041907,10 uM,24 h,3,45,48,1,401,192,209,NPC
BRD-K79382620_10uM_24h,BRD-K79382620,10 uM,24 h,3,27,30,1,17,6,11,NPC
2-aminopurine_10uM_24h,2-aminopurine,10 uM,24 h,3,29,32,1,4,2,2,NPC
BRD-K91047982_10uM_24h,BRD-K91047982,10 uM,24 h,3,29,32,1,3,1,2,NPC
BRD-K70918484_10uM_24h,BRD-K70918484,10 uM,24 h,3,45,48,1,5,1,4,NPC
BRD-K24426149_10uM_24h,BRD-K24426149,10 uM,24 h,3,29,32,1,6,5,1,NPC
BRD-K05542495_10uM_24h,BRD-K05542495,10 uM,24 h,3,29,32,1,0,0,0,NPC
BRD-K74085580_10uM_24h,BRD-K74085580,10 uM,24 h,3,45,48,1,17,10,7,NPC
BRD-K18747403_10uM_24h,BRD-K18747403,10 uM,24 h,3,54,57,1,7,2,5,NPC
BRD-K72620090_10uM_24h,BRD-K72620090,10 uM,24 h,3,45,48,1,4,4,0,NPC
BRD-K71498541_10uM_24h,BRD-K71498541,10 uM,24 h,3,54,57,1,5,0,5,NPC
BRD-K42687792_10uM_24h,BRD-K42687792,10 uM,24 h,3,27,30,1,234,69,165,NPC
BRD-K67506692_10uM_24h,BRD-K67506692,10 uM,24 h,3,29,32,1,0,0,0,NPC
BRD-K98710661_10uM_24h,BRD-K98710661,10 uM,24 h,3,54,57,1,19,11,8,NPC
BRD-K91355947_10uM_24h,BRD-K91355947,10 uM,24 h,3,27,30,1,9,1,8,NPC
BRD-K75903201_10uM_24h,BRD-K75903201,10 uM,24 h,3,29,32,1,0,0,0,NPC
TMI-15_10uM_24h,TMI-15,10 uM,24 h,3,29,32,1,0,0,0,NPC
BRD-K10421834_10uM_24h,BRD-K10421834,10 uM,24 h,3,45,48,1,46,18,28,NPC
BRD-K33318635_10uM_24h,BRD-K33318635,10 uM,24 h,3,54,57,1,3,2,1,NPC
BRD-K09069264_10uM_24h,BRD-K09069264,10 uM,24 h,3,45,48,1,151,73,78,NPC
BRD-K41335306_10uM_24h,BRD-K41335306,10 uM,24 h,3,54,57,1,4,2,2,NPC
BRD-K11359987_10uM_24h,BRD-K11359987,10 uM,24 h,3,54,57,1,6,3,3,NPC
BRD-K91745259_10uM_24h,BRD-K91745259,10 uM,24 h,3,54,57,1,3,2,1,NPC
BRD-K18074178_10uM_24h,BRD-K18074178,10 uM,24 h,3,29,32,1,0,0,0,NPC
BRD-K61217870_10uM_24h,BRD-K61217870,10 uM,24 h,3,27,30,1,1,0,1,NPC
dihydrorobustic-acid_10uM_24h,dihydrorobustic-acid,10 uM,24 h,3,32,35,1,0,0,0,NPC
DMBI_10uM_24h,DMBI,10 uM,24 h,3,32,35,1,2,2,0,NPC
BRD-K70891562_10uM_24h,BRD-K70891562,10 uM,24 h,3,29,32,1,135,33,102,NPC
BRD-K09957764_10uM_24h,BRD-K09957764,10 uM,24 h,3,45,48,1,3,2,1,NPC
LY-341495_10uM_24h,LY-341495,10 uM,24 h,3,32,35,1,0,0,0,NPC
BRD-K33591392_10uM_24h,BRD-K33591392,10 uM,24 h,3,54,57,1,1,1,0,NPC
BRD-K16934333_10uM_24h,BRD-K16934333,10 uM,24 h,3,54,57,1,31,14,17,NPC
WT-171_10uM_24h,WT-171,10 uM,24 h,3,29,32,1,62,27,35,NPC
NK42-I-109-1_10uM_24h,NK42-I-109-1,10 uM,24 h,3,27,30,1,0,0,0,NPC
BRD-K97103850_10uM_24h,BRD-K97103850,10 uM,24 h,3,54,57,1,10,3,7,NPC
BRD-K06623064_10uM_24h,BRD-K06623064,10 uM,24 h,3,27,30,1,6,3,3,NPC
tenovins_10uM_24h,tenovins,10 uM,24 h,3,29,32,1,2,1,1,NPC
BRD-K85174275_10uM_24h,BRD-K85174275,10 uM,24 h,3,45,48,1,23,10,13,NPC
BRD-K30645599_10uM_24h,BRD-K30645599,10 uM,24 h,3,45,48,1,14,5,9,NPC
BRD-K37340241_10uM_24h,BRD-K37340241,10 uM,24 h,3,27,30,1,318,113,205,NPC
BRD-K55071917_10uM_24h,BRD-K55071917,10 uM,24 h,3,27,30,1,0,0,0,NPC
BRD-A60386802_10uM_24h,BRD-A60386802,10 uM,24 h,3,27,30,1,21,8,13,NPC
BRD-K71574320_10uM_24h,BRD-K71574320,10 uM,24 h,3,29,32,1,8,1,7,NPC
BRD-K54822214_10uM_24h,BRD-K54822214,10 uM,24 h,3,29,32,1,0,0,0,NPC
BGT-226_0.37uM_24h,BGT-226,0.37 uM,24 h,3,66,69,1,731,291,440,NPC
BRD-K36614862_0.37uM_24h,BRD-K36614862,0.37 uM,24 h,3,40,43,1,9,5,4,NPC
vorinostat_10uM_24h,vorinostat,10 uM,24 h,32,336,368,11,576,301,275,NEU
wortmannin_10uM_24h,wortmannin,10 uM,24 h,25,206,231,8,198,57,141,NEU
geldanamycin_10uM_24h,geldanamycin,10 uM,24 h,21,187,208,8,381,140,241,NEU
sirolimus_10uM_24h,sirolimus,10 uM,24 h,16,218,234,6,253,91,162,NEU
dopamine_10uM_24h,dopamine,10 uM,24 h,12,25,37,1,0,0,0,NEU
vorinostat_10uM_6h,vorinostat,10 uM,6 h,12,76,88,2,344,199,145,NEU
dopamine_10uM_6h,dopamine,10 uM,6 h,12,47,59,1,0,0,0,NEU
tretinoin_10uM_24h,tretinoin,10 uM,24 h,11,76,87,3,6,6,0,NEU
PD-0325901_10uM_24h,PD-0325901,10 uM,24 h,11,178,189,5,4,1,3,NEU
resveratrol_10uM_24h,resveratrol,10 uM,24 h,11,80,91,2,86,31,55,NEU
decitabine_10uM_24h,decitabine,10 uM,24 h,10,96,106,3,0,0,0,NEU
troglitazone_10uM_24h,troglitazone,10 uM,24 h,10,81,91,3,0,0,0,NEU
retinol_10uM_24h,retinol,10 uM,24 h,10,44,54,2,3,1,2,NEU
serotonin_10uM_24h,serotonin,10 uM,24 h,9,25,34,1,0,0,0,NEU
valproic-acid_10uM_6h,valproic-acid,10 uM,6 h,9,29,38,1,0,0,0,NEU
serotonin_10uM_6h,serotonin,10 uM,6 h,9,47,56,1,0,0,0,NEU
GW-9662_10uM_24h,GW-9662,10 uM,24 h,9,56,65,2,0,0,0,NEU
tetrabenazine_10uM_6h,tetrabenazine,10 uM,6 h,9,47,56,1,2,2,0,NEU
pyrazolanthrone_10uM_24h,pyrazolanthrone,10 uM,24 h,9,121,130,3,1,1,0,NEU
tacedinaline_10uM_24h,tacedinaline,10 uM,24 h,9,24,33,1,605,230,375,NEU
nemonapride_10uM_24h,nemonapride,10 uM,24 h,9,57,66,2,0,0,0,NEU
valproic-acid_10uM_24h,valproic-acid,10 uM,24 h,9,24,33,1,25,4,21,NEU
resveratrol_10uM_6h,resveratrol,10 uM,6 h,9,29,38,1,0,0,0,NEU
riluzole_10uM_24h,riluzole,10 uM,24 h,9,81,90,3,50,13,37,NEU
tetrabenazine_10uM_24h,tetrabenazine,10 uM,24 h,9,25,34,1,0,0,0,NEU
tanespimycin_10uM_24h,tanespimycin,10 uM,24 h,8,158,166,4,30,16,14,NEU
BIX-01294_10uM_24h,BIX-01294,10 uM,24 h,8,93,101,4,197,76,121,NEU
dasatinib_10uM_24h,dasatinib,10 uM,24 h,8,158,166,4,79,13,66,NEU
pregnenolone_10uM_24h,pregnenolone,10 uM,24 h,8,44,52,2,110,36,74,NEU
wortmannin_10uM_6h,wortmannin,10 uM,6 h,8,60,68,2,28,13,15,NEU
tacedinaline_10uM_6h,tacedinaline,10 uM,6 h,8,29,37,1,217,68,149,NEU
tranylcypromine_10uM_24h,tranylcypromine,10 uM,24 h,8,105,113,3,57,14,43,NEU
geldanamycin_10uM_6h,geldanamycin,10 uM,6 h,7,45,52,2,87,45,42,NEU
ZM-447439_10uM_24h,ZM-447439,10 uM,24 h,7,101,108,3,0,0,0,NEU
sorafenib_10uM_24h,sorafenib,10 uM,24 h,7,40,47,2,59,34,25,NEU
imatinib_10uM_24h,imatinib,10 uM,24 h,7,32,39,2,0,0,0,NEU
SB-239063_10uM_24h,SB-239063,10 uM,24 h,7,109,116,3,30,21,9,NEU
fenretinide_10uM_24h,fenretinide,10 uM,24 h,7,44,51,2,202,69,133,NEU
apigenin_10uM_24h,apigenin,10 uM,24 h,7,44,51,2,0,0,0,NEU
SB-216763_10uM_24h,SB-216763,10 uM,24 h,7,45,52,2,23,7,16,NEU
splitomycin_10uM_24h,splitomycin,10 uM,24 h,6,49,55,2,0,0,0,NEU
progesterone_10uM_24h,progesterone,10 uM,24 h,6,56,62,2,5,2,3,NEU
splitomycin_10uM_6h,splitomycin,10 uM,6 h,6,76,82,2,0,0,0,NEU
CHIR-99021_10uM_24h,CHIR-99021,10 uM,24 h,6,49,55,2,106,55,51,NEU
clofibric-acid_10uM_24h,clofibric-acid,10 uM,24 h,6,56,62,2,0,0,0,NEU
doconexent_10uM_24h,doconexent,10 uM,24 h,6,24,30,1,0,0,0,NEU
oxidopamine_10uM_24h,oxidopamine,10 uM,24 h,6,25,31,1,10,4,6,NEU
decitabine_10uM_6h,decitabine,10 uM,6 h,6,29,35,1,0,0,0,NEU
fenobam_10uM_24h,fenobam,10 uM,24 h,6,57,63,2,0,0,0,NEU
tranylcypromine_10uM_6h,tranylcypromine,10 uM,6 h,6,76,82,2,1,1,0,NEU
GW-9662_10uM_6h,GW-9662,10 uM,6 h,6,29,35,1,0,0,0,NEU
XAV-939_10uM_6h,XAV-939,10 uM,6 h,6,76,82,2,0,0,0,NEU
sulindac_10uM_6h,sulindac,10 uM,6 h,6,29,35,1,0,0,0,NEU
riluzole_10uM_6h,riluzole,10 uM,6 h,6,76,82,2,0,0,0,NEU
bosutinib_10uM_24h,bosutinib,10 uM,24 h,6,65,71,3,47,23,24,NEU
anisomycin_10uM_24h,anisomycin,10 uM,24 h,6,56,62,2,297,147,150,NEU
doconexent_10uM_6h,doconexent,10 uM,6 h,6,29,35,1,0,0,0,NEU
curcumin_10uM_6h,curcumin,10 uM,6 h,6,29,35,1,12,2,10,NEU
FK-866_10uM_24h,FK-866,10 uM,24 h,6,49,55,2,0,0,0,NEU
quinidine_10uM_24h,quinidine,10 uM,24 h,6,56,62,2,0,0,0,NEU
nemonapride_10uM_6h,nemonapride,10 uM,6 h,6,47,53,1,0,0,0,NEU
imatinib_10uM_6h,imatinib,10 uM,6 h,6,29,35,1,0,0,0,NEU
sirtinol_10uM_24h,sirtinol,10 uM,24 h,6,49,55,2,53,14,39,NEU
CHIR-99021_10uM_6h,CHIR-99021,10 uM,6 h,6,76,82,2,16,14,2,NEU
SB-216763_10uM_6h,SB-216763,10 uM,6 h,6,29,35,1,10,3,7,NEU
sulindac_10uM_24h,sulindac,10 uM,24 h,6,24,30,1,0,0,0,NEU
tamoxifen_10uM_24h,tamoxifen,10 uM,24 h,6,24,30,1,11,10,1,NEU
KU-55933_10uM_24h,KU-55933,10 uM,24 h,6,76,82,2,2,1,1,NEU
FK-866_10uM_6h,FK-866,10 uM,6 h,6,76,82,2,0,0,0,NEU
sirtinol_10uM_6h,sirtinol,10 uM,6 h,6,76,82,2,0,0,0,NEU
mevastatin_10uM_24h,mevastatin,10 uM,24 h,6,57,63,2,2,2,0,NEU
D-4476_10uM_24h,D-4476,10 uM,24 h,6,89,95,2,2,1,1,NEU
forskolin_10uM_24h,forskolin,10 uM,24 h,6,24,30,1,65,7,58,NEU
troglitazone_10uM_6h,troglitazone,10 uM,6 h,6,29,35,1,0,0,0,NEU
anandamide_10uM_24h,anandamide,10 uM,24 h,6,56,62,2,0,0,0,NEU
BIX-01294_10uM_6h,BIX-01294,10 uM,6 h,6,76,82,2,135,64,71,NEU
pregnenolone_10uM_6h,pregnenolone,10 uM,6 h,6,29,35,1,2,0,2,NEU
SB-202190_10uM_24h,SB-202190,10 uM,24 h,6,56,62,2,2,1,1,NEU
tretinoin_10uM_6h,tretinoin,10 uM,6 h,6,29,35,1,1,0,1,NEU
tamoxifen_10uM_6h,tamoxifen,10 uM,6 h,6,29,35,1,0,0,0,NEU
curcumin_10uM_24h,curcumin,10 uM,24 h,6,24,30,1,14,2,12,NEU
mifepristone_10uM_24h,mifepristone,10 uM,24 h,6,56,62,2,2,2,0,NEU
entinostat_10uM_24h,entinostat,10 uM,24 h,6,92,98,3,73,46,27,NEU
forskolin_10uM_6h,forskolin,10 uM,6 h,6,29,35,1,0,0,0,NEU
oxidopamine_10uM_6h,oxidopamine,10 uM,6 h,6,47,53,1,2,2,0,NEU
retinol_10uM_6h,retinol,10 uM,6 h,6,29,35,1,0,0,0,NEU
XAV-939_10uM_24h,XAV-939,10 uM,24 h,6,49,55,2,365,115,250,NEU
CGS-21680_10uM_24h,CGS-21680,10 uM,24 h,6,57,63,2,0,0,0,NEU
niclosamide_10uM_6h,niclosamide,10 uM,6 h,6,29,35,1,4,2,2,NEU
PD-0325901_0.04uM_24h,PD-0325901,0.04 uM,24 h,6,142,148,3,2,1,1,NEU
dasatinib_0.04uM_24h,dasatinib,0.04 uM,24 h,6,142,148,3,4,1,3,NEU
PD-0325901_0.12uM_24h,PD-0325901,0.12 uM,24 h,6,142,148,3,1,0,1,NEU
dasatinib_0.12uM_24h,dasatinib,0.12 uM,24 h,6,142,148,3,7,2,5,NEU
vorinostat_0.37uM_24h,vorinostat,0.37 uM,24 h,6,113,119,3,3,1,2,NEU
dasatinib_0.37uM_24h,dasatinib,0.37 uM,24 h,6,142,148,3,7,1,6,NEU
PD-0325901_0.37uM_24h,PD-0325901,0.37 uM,24 h,6,142,148,3,2,0,2,NEU
vorinostat_1.11uM_24h,vorinostat,1.11 uM,24 h,6,113,119,3,49,32,17,NEU
PD-0325901_1.11uM_24h,PD-0325901,1.11 uM,24 h,6,142,148,3,3,2,1,NEU
vorinostat_3.33uM_24h,vorinostat,3.33 uM,24 h,6,113,119,3,207,104,103,NEU
dasatinib_3.33uM_24h,dasatinib,3.33 uM,24 h,6,142,148,3,3,1,2,NEU
PD-0325901_3.33uM_24h,PD-0325901,3.33 uM,24 h,6,142,148,3,1,0,1,NEU
VX-745_10uM_24h,VX-745,10 uM,24 h,5,85,90,2,0,0,0,NEU
genistein_10uM_24h,genistein,10 uM,24 h,5,44,49,2,3,1,2,NEU
kenpaullone_10uM_24h,kenpaullone,10 uM,24 h,5,48,53,2,1,0,1,NEU
isotretinoin_10uM_24h,isotretinoin,10 uM,24 h,5,44,49,2,1,1,0,NEU
olaparib_10uM_24h,olaparib,10 uM,24 h,5,121,126,2,2,1,1,NEU
zonisamide_10uM_6h,zonisamide,10 uM,6 h,5,47,52,1,0,0,0,NEU
oleoylethanolamide_10uM_24h,oleoylethanolamide,10 uM,24 h,5,44,49,2,95,43,52,NEU
WZ-4002_10uM_24h,WZ-4002,10 uM,24 h,5,41,46,2,17,7,10,NEU
veliparib_10uM_24h,veliparib,10 uM,24 h,5,121,126,2,1,1,0,NEU
niclosamide_10uM_24h,niclosamide,10 uM,24 h,5,24,29,1,239,49,190,NEU
EX-527_10uM_24h,EX-527,10 uM,24 h,5,80,85,2,0,0,0,NEU
NVP-TAE684_10uM_24h,NVP-TAE684,10 uM,24 h,5,36,41,2,8,2,6,NEU
SB-203580_10uM_24h,SB-203580,10 uM,24 h,5,85,90,2,1,0,1,NEU
spiperone_10uM_24h,spiperone,10 uM,24 h,5,46,51,2,5,1,4,NEU
tetradecylthioacetic-acid_10uM_24h,tetradecylthioacetic-acid,10 uM,24 h,5,44,49,2,17,3,14,NEU
dexamethasone_10uM_24h,dexamethasone,10 uM,24 h,5,44,49,2,15,5,10,NEU
GDC-0879_10uM_24h,GDC-0879,10 uM,24 h,5,85,90,2,1,1,0,NEU
etodolac_10uM_24h,etodolac,10 uM,24 h,5,52,57,2,0,0,0,NEU
GNF-2_10uM_24h,GNF-2,10 uM,24 h,5,81,86,2,3,2,1,NEU
calcifediol_10uM_24h,calcifediol,10 uM,24 h,5,44,49,2,2,0,2,NEU
calcitriol_10uM_24h,calcitriol,10 uM,24 h,5,44,49,2,1,0,1,NEU
triciribine_10uM_24h,triciribine,10 uM,24 h,5,52,57,2,0,0,0,NEU
lapatinib_10uM_24h,lapatinib,10 uM,24 h,5,52,57,2,2,2,0,NEU
cholic-acid_10uM_24h,cholic-acid,10 uM,24 h,5,44,49,2,0,0,0,NEU
TTNPB_10uM_24h,TTNPB,10 uM,24 h,5,44,49,2,2,0,2,NEU
zonisamide_10uM_24h,zonisamide,10 uM,24 h,5,25,30,1,0,0,0,NEU
PD-173074_10uM_24h,PD-173074,10 uM,24 h,5,36,41,2,30,21,9,NEU
veliparib_0.04uM_24h,veliparib,0.04 uM,24 h,5,121,126,2,11,3,8,NEU
olaparib_0.04uM_24h,olaparib,0.04 uM,24 h,5,121,126,2,40,14,26,NEU
olaparib_0.12uM_24h,olaparib,0.12 uM,24 h,5,121,126,2,2,2,0,NEU
veliparib_0.12uM_24h,veliparib,0.12 uM,24 h,5,121,126,2,231,84,147,NEU
veliparib_0.37uM_24h,veliparib,0.37 uM,24 h,5,121,126,2,273,90,183,NEU
olaparib_0.37uM_24h,olaparib,0.37 uM,24 h,5,121,126,2,1,0,1,NEU
olaparib_1.11uM_24h,olaparib,1.11 uM,24 h,5,121,126,2,0,0,0,NEU
dasatinib_1.11uM_24h,dasatinib,1.11 uM,24 h,5,120,125,3,9,5,4,NEU
veliparib_1.11uM_24h,veliparib,1.11 uM,24 h,5,121,126,2,3,0,3,NEU
veliparib_3.33uM_24h,veliparib,3.33 uM,24 h,5,121,126,2,33,13,20,NEU
olaparib_3.33uM_24h,olaparib,3.33 uM,24 h,5,121,126,2,1,1,0,NEU
belinostat_10uM_24h,belinostat,10 uM,24 h,4,72,76,2,171,80,91,NEU
gefitinib_10uM_24h,gefitinib,10 uM,24 h,4,20,24,1,1,1,0,NEU
acitretin_10uM_24h,acitretin,10 uM,24 h,4,36,40,2,1,1,0,NEU
vinorelbine_10uM_24h,vinorelbine,10 uM,24 h,4,20,24,1,31,12,19,NEU
fulvestrant_10uM_24h,fulvestrant,10 uM,24 h,4,57,61,2,0,0,0,NEU
GW-441756_10uM_24h,GW-441756,10 uM,24 h,4,44,48,2,0,0,0,NEU
TAK-715_10uM_24h,TAK-715,10 uM,24 h,4,73,77,2,0,0,0,NEU
ruxolitinib_10uM_24h,ruxolitinib,10 uM,24 h,4,20,24,1,2,1,1,NEU
CP-724714_10uM_24h,CP-724714,10 uM,24 h,4,16,20,1,0,0,0,NEU
barasertib-HQPA_10uM_24h,barasertib-HQPA,10 uM,24 h,4,36,40,2,0,0,0,NEU
mocetinostat_10uM_24h,mocetinostat,10 uM,24 h,4,76,80,2,76,28,48,NEU
fludarabine_10uM_24h,fludarabine,10 uM,24 h,4,42,46,2,353,125,228,NEU
motesanib_10uM_24h,motesanib,10 uM,24 h,4,49,53,3,8,7,1,NEU
ZSTK-474_10uM_24h,ZSTK-474,10 uM,24 h,4,36,40,2,3,1,2,NEU
HMN-214_10uM_24h,HMN-214,10 uM,24 h,4,73,77,2,8,7,1,NEU
alvocidib_10uM_24h,alvocidib,10 uM,24 h,4,40,44,2,0,0,0,NEU
enzastaurin_10uM_24h,enzastaurin,10 uM,24 h,4,20,24,1,0,0,0,NEU
tozasertib_10uM_24h,tozasertib,10 uM,24 h,4,16,20,1,0,0,0,NEU
PD-184352_10uM_24h,PD-184352,10 uM,24 h,4,36,40,2,0,0,0,NEU
fulvestrant_0.37uM_24h,fulvestrant,0.37 uM,24 h,4,57,61,2,0,0,0,NEU
wortmannin_0.37uM_24h,wortmannin,0.37 uM,24 h,4,57,61,2,27,8,19,NEU
geldanamycin_0.37uM_24h,geldanamycin,0.37 uM,24 h,4,57,61,2,0,0,0,NEU
geldanamycin_1.11uM_24h,geldanamycin,1.11 uM,24 h,4,57,61,2,22,7,15,NEU
fulvestrant_1.11uM_24h,fulvestrant,1.11 uM,24 h,4,57,61,2,3,1,2,NEU
wortmannin_1.11uM_24h,wortmannin,1.11 uM,24 h,4,57,61,2,46,12,34,NEU
troglitazone_1.11uM_24h,troglitazone,1.11 uM,24 h,4,57,61,2,1,1,0,NEU
wortmannin_3.33uM_24h,wortmannin,3.33 uM,24 h,4,57,61,2,4,3,1,NEU
fulvestrant_3.33uM_24h,fulvestrant,3.33 uM,24 h,4,57,61,2,0,0,0,NEU
geldanamycin_3.33uM_24h,geldanamycin,3.33 uM,24 h,4,57,61,2,28,8,20,NEU
L-690330_10uM_6h,L-690330,10 uM,6 h,3,29,32,1,0,0,0,NEU
tolazamide_10uM_24h,tolazamide,10 uM,24 h,3,24,27,1,1,1,0,NEU
PD-166793_10uM_24h,PD-166793,10 uM,24 h,3,32,35,1,3,2,1,NEU
loperamide_10uM_6h,loperamide,10 uM,6 h,3,29,32,1,5,4,1,NEU
rilmenidine_10uM_24h,rilmenidine,10 uM,24 h,3,24,27,1,93,39,54,NEU
carbamazepine_10uM_24h,carbamazepine,10 uM,24 h,3,24,27,1,31,6,25,NEU
hydroxychloroquine_10uM_6h,hydroxychloroquine,10 uM,6 h,3,29,32,1,0,0,0,NEU
buspirone_10uM_24h,buspirone,10 uM,24 h,3,32,35,1,0,0,0,NEU
dacinostat_10uM_24h,dacinostat,10 uM,24 h,3,20,23,1,0,0,0,NEU
T-0156_10uM_24h,T-0156,10 uM,24 h,3,32,35,1,0,0,0,NEU
lonidamine_10uM_24h,lonidamine,10 uM,24 h,3,32,35,1,0,0,0,NEU
MG-132_10uM_24h,MG-132,10 uM,24 h,3,24,27,1,489,186,303,NEU
10-DEBC_10uM_24h,10-DEBC,10 uM,24 h,3,24,27,1,2,0,2,NEU
isradipine_10uM_6h,isradipine,10 uM,6 h,3,47,50,1,1,1,0,NEU
trifluridine_10uM_24h,trifluridine,10 uM,24 h,3,25,28,1,2,1,1,NEU
pyrvinium-pamoate_10uM_6h,pyrvinium-pamoate,10 uM,6 h,3,29,32,1,19,13,6,NEU
mebeverine_10uM_24h,mebeverine,10 uM,24 h,3,32,35,1,5,3,2,NEU
nafcillin_10uM_24h,nafcillin,10 uM,24 h,3,32,35,1,0,0,0,NEU
PD-168077_10uM_24h,PD-168077,10 uM,24 h,3,32,35,1,1,1,0,NEU
serdemetan_10uM_24h,serdemetan,10 uM,24 h,3,65,68,1,6,3,3,NEU
KI-20227_10uM_24h,KI-20227,10 uM,24 h,3,65,68,1,0,0,0,NEU
cinchonine_10uM_24h,cinchonine,10 uM,24 h,3,32,35,1,1,0,1,NEU
pinocembrin_10uM_24h,pinocembrin,10 uM,24 h,3,32,35,1,0,0,0,NEU
nefazodone_10uM_24h,nefazodone,10 uM,24 h,3,32,35,1,1,0,1,NEU
CPCCOEt_10uM_6h,CPCCOEt,10 uM,6 h,3,47,50,1,1,0,1,NEU
GGTI-298_10uM_24h,GGTI-298,10 uM,24 h,3,25,28,1,3,2,1,NEU
carbidopa_10uM_24h,carbidopa,10 uM,24 h,3,25,28,1,5,2,3,NEU
piceatannol_10uM_24h,piceatannol,10 uM,24 h,3,24,27,1,163,28,135,NEU
NVP-BEZ235_10uM_6h,NVP-BEZ235,10 uM,6 h,3,29,32,1,4,1,3,NEU
ceforanide_10uM_24h,ceforanide,10 uM,24 h,3,32,35,1,0,0,0,NEU
BML-190_10uM_24h,BML-190,10 uM,24 h,3,32,35,1,0,0,0,NEU
L-693403_10uM_24h,L-693403,10 uM,24 h,3,32,35,1,5,1,4,NEU
verapamil_10uM_24h,verapamil,10 uM,24 h,3,24,27,1,91,19,72,NEU
BML-284_10uM_24h,BML-284,10 uM,24 h,3,24,27,1,397,130,267,NEU
M-344_10uM_24h,M-344,10 uM,24 h,3,24,27,1,340,166,174,NEU
tenidap_10uM_24h,tenidap,10 uM,24 h,3,32,35,1,0,0,0,NEU
PD-198306_10uM_24h,PD-198306,10 uM,24 h,3,32,35,1,13,8,5,NEU
vinblastine_10uM_24h,vinblastine,10 uM,24 h,3,32,35,1,27,15,12,NEU
BI-2536_10uM_24h,BI-2536,10 uM,24 h,3,65,68,1,0,0,0,NEU
PNU-22394_10uM_24h,PNU-22394,10 uM,24 h,3,32,35,1,0,0,0,NEU
fluvastatin_10uM_24h,fluvastatin,10 uM,24 h,3,25,28,1,1,1,0,NEU
glucosamine_10uM_6h,glucosamine,10 uM,6 h,3,29,32,1,0,0,0,NEU
SR-59230A_10uM_24h,SR-59230A,10 uM,24 h,3,32,35,1,0,0,0,NEU
Ro-15-4513_10uM_24h,Ro-15-4513,10 uM,24 h,3,32,35,1,0,0,0,NEU
nitrendipine_10uM_24h,nitrendipine,10 uM,24 h,3,24,27,1,6,3,3,NEU
atorvastatin_10uM_24h,atorvastatin,10 uM,24 h,3,25,28,1,2,2,0,NEU
verapamil_10uM_6h,verapamil,10 uM,6 h,3,29,32,1,3,2,1,NEU
chlorhexidine_10uM_6h,chlorhexidine,10 uM,6 h,3,47,50,1,10,9,1,NEU
lisuride_10uM_24h,lisuride,10 uM,24 h,3,32,35,1,1,1,0,NEU
AMN-082_10uM_24h,AMN-082,10 uM,24 h,3,32,35,1,0,0,0,NEU
bromhexine_10uM_24h,bromhexine,10 uM,24 h,3,32,35,1,76,13,63,NEU
pterostilbene_10uM_6h,pterostilbene,10 uM,6 h,3,29,32,1,2,1,1,NEU
minoxidil_10uM_6h,minoxidil,10 uM,6 h,3,29,32,1,0,0,0,NEU
scriptaid_10uM_6h,scriptaid,10 uM,6 h,3,29,32,1,121,76,45,NEU
CGP-55845_10uM_24h,CGP-55845,10 uM,24 h,3,32,35,1,0,0,0,NEU
JNJ-38877605_10uM_24h,JNJ-38877605,10 uM,24 h,3,65,68,1,1,0,1,NEU
osthol_10uM_24h,osthol,10 uM,24 h,3,32,35,1,1,0,1,NEU
imiquimod_10uM_6h,imiquimod,10 uM,6 h,3,29,32,1,0,0,0,NEU
alpha-methylserotonin_10uM_6h,alpha-methylserotonin,10 uM,6 h,3,47,50,1,1,1,0,NEU
MRS-1220_10uM_24h,MRS-1220,10 uM,24 h,3,32,35,1,0,0,0,NEU
SR-95639A_10uM_24h,SR-95639A,10 uM,24 h,3,32,35,1,3,3,0,NEU
PNU-74654_10uM_24h,PNU-74654,10 uM,24 h,3,24,27,1,0,0,0,NEU
RU-24969_10uM_24h,RU-24969,10 uM,24 h,3,25,28,1,0,0,0,NEU
GW-4064_10uM_24h,GW-4064,10 uM,24 h,3,24,27,1,1,0,1,NEU
simvastatin_10uM_6h,simvastatin,10 uM,6 h,3,47,50,1,18,12,6,NEU
ephedrine_10uM_6h,ephedrine,10 uM,6 h,3,47,50,1,5,4,1,NEU
irinotecan_10uM_24h,irinotecan,10 uM,24 h,3,32,35,1,7,4,3,NEU
Ro-10-5824_10uM_24h,Ro-10-5824,10 uM,24 h,3,32,35,1,0,0,0,NEU
SIB-1757_10uM_24h,SIB-1757,10 uM,24 h,3,32,35,1,0,0,0,NEU
clonidine_10uM_24h,clonidine,10 uM,24 h,3,24,27,1,0,0,0,NEU
bezafibrate_10uM_6h,bezafibrate,10 uM,6 h,3,29,32,1,0,0,0,NEU
rimonabant_10uM_6h,rimonabant,10 uM,6 h,3,47,50,1,11,7,4,NEU
JNJ-16259685_10uM_24h,JNJ-16259685,10 uM,24 h,3,25,28,1,1,0,1,NEU
capsaicin_10uM_24h,capsaicin,10 uM,24 h,3,24,27,1,47,16,31,NEU
SB-202190_10uM_6h,SB-202190,10 uM,6 h,3,29,32,1,1,0,1,NEU
fenretinide_10uM_6h,fenretinide,10 uM,6 h,3,29,32,1,9,4,5,NEU
cabergoline_10uM_24h,cabergoline,10 uM,24 h,3,32,35,1,0,0,0,NEU
pyrrolidine-dithiocarbamate_10uM_24h,pyrrolidine-dithiocarbamate,10 uM,24 h,3,32,35,1,5,4,1,NEU
lidoflazine_10uM_24h,lidoflazine,10 uM,24 h,3,32,35,1,5,2,3,NEU
SKF-81297_10uM_6h,SKF-81297,10 uM,6 h,3,47,50,1,0,0,0,NEU
zardaverine_10uM_24h,zardaverine,10 uM,24 h,3,32,35,1,4,4,0,NEU
Y-134_10uM_24h,Y-134,10 uM,24 h,3,32,35,1,75,27,48,NEU
thalidomide_10uM_6h,thalidomide,10 uM,6 h,3,29,32,1,1,0,1,NEU
scriptaid_10uM_24h,scriptaid,10 uM,24 h,3,24,27,1,425,209,216,NEU
genistein_10uM_6h,genistein,10 uM,6 h,3,29,32,1,0,0,0,NEU
MPEP_10uM_24h,MPEP,10 uM,24 h,3,25,28,1,114,34,80,NEU
trifluoperazine_10uM_6h,trifluoperazine,10 uM,6 h,3,29,32,1,4,4,0,NEU
BADGE_10uM_24h,BADGE,10 uM,24 h,3,24,27,1,0,0,0,NEU
U-18666A_10uM_24h,U-18666A,10 uM,24 h,3,32,35,1,2,2,0,NEU
PP-1_10uM_24h,PP-1,10 uM,24 h,3,32,35,1,0,0,0,NEU
fenbufen_10uM_24h,fenbufen,10 uM,24 h,3,32,35,1,0,0,0,NEU
BX-795_10uM_24h,BX-795,10 uM,24 h,3,65,68,1,1,1,0,NEU
estradiol_10uM_24h,estradiol,10 uM,24 h,3,24,27,1,109,49,60,NEU
proadifen_10uM_24h,proadifen,10 uM,24 h,3,32,35,1,7,3,4,NEU
spiperone_10uM_6h,spiperone,10 uM,6 h,3,47,50,1,5,2,3,NEU
YM-298198_10uM_24h,YM-298198,10 uM,24 h,3,25,28,1,3,2,1,NEU
piceatannol_10uM_6h,piceatannol,10 uM,6 h,3,29,32,1,29,23,6,NEU
JLK-6_10uM_24h,JLK-6,10 uM,24 h,3,32,35,1,3,1,2,NEU
piperidolate_10uM_24h,piperidolate,10 uM,24 h,3,32,35,1,0,0,0,NEU
clozapine_10uM_24h,clozapine,10 uM,24 h,3,25,28,1,1,0,1,NEU
carbidopa_10uM_6h,carbidopa,10 uM,6 h,3,47,50,1,3,2,1,NEU
norcyclobenzaprine_10uM_24h,norcyclobenzaprine,10 uM,24 h,3,32,35,1,0,0,0,NEU
L-745870_10uM_24h,L-745870,10 uM,24 h,3,32,35,1,3,3,0,NEU
bendroflumethiazide_10uM_24h,bendroflumethiazide,10 uM,24 h,3,32,35,1,0,0,0,NEU
TNP-470_10uM_6h,TNP-470,10 uM,6 h,3,29,32,1,1,1,0,NEU
cerulenin_10uM_6h,cerulenin,10 uM,6 h,3,47,50,1,1,1,0,NEU
STF-62247_10uM_6h,STF-62247,10 uM,6 h,3,29,32,1,1,0,1,NEU
dexamethasone_10uM_6h,dexamethasone,10 uM,6 h,3,29,32,1,1,1,0,NEU
hexachlorophene_10uM_6h,hexachlorophene,10 uM,6 h,3,29,32,1,3,1,2,NEU
glucosamine_10uM_24h,glucosamine,10 uM,24 h,3,24,27,1,4,2,2,NEU
telmisartan_10uM_24h,telmisartan,10 uM,24 h,3,32,35,1,0,0,0,NEU
risperidone_10uM_6h,risperidone,10 uM,6 h,3,47,50,1,9,9,0,NEU
GW-7647_10uM_6h,GW-7647,10 uM,6 h,3,29,32,1,0,0,0,NEU
mifepristone_10uM_6h,mifepristone,10 uM,6 h,3,29,32,1,0,0,0,NEU
meprylcaine_10uM_24h,meprylcaine,10 uM,24 h,3,32,35,1,0,0,0,NEU
bepridil_10uM_24h,bepridil,10 uM,24 h,3,32,35,1,0,0,0,NEU
FK-888_10uM_24h,FK-888,10 uM,24 h,3,32,35,1,1,1,0,NEU
phenformin_10uM_24h,phenformin,10 uM,24 h,3,32,35,1,2,0,2,NEU
trazodone_10uM_24h,trazodone,10 uM,24 h,3,32,35,1,0,0,0,NEU
cilostamide_10uM_24h,cilostamide,10 uM,24 h,3,32,35,1,0,0,0,NEU
fluspirilene_10uM_6h,fluspirilene,10 uM,6 h,3,29,32,1,0,0,0,NEU
diclofenac_10uM_24h,diclofenac,10 uM,24 h,3,24,27,1,282,76,206,NEU
tetradecylthioacetic-acid_10uM_6h,tetradecylthioacetic-acid,10 uM,6 h,3,29,32,1,0,0,0,NEU
calcifediol_10uM_6h,calcifediol,10 uM,6 h,3,29,32,1,0,0,0,NEU
WAY-100635_10uM_24h,WAY-100635,10 uM,24 h,3,25,28,1,93,12,81,NEU
remoxipride_10uM_24h,remoxipride,10 uM,24 h,3,32,35,1,1,1,0,NEU
hydralazine_10uM_24h,hydralazine,10 uM,24 h,3,32,35,1,0,0,0,NEU
pravastatin_10uM_24h,pravastatin,10 uM,24 h,3,25,28,1,0,0,0,NEU
estradiol_10uM_6h,estradiol,10 uM,6 h,3,29,32,1,1,0,1,NEU
CS-110266_10uM_24h,CS-110266,10 uM,24 h,3,25,28,1,6,4,2,NEU
levonorgestrel_10uM_24h,levonorgestrel,10 uM,24 h,3,32,35,1,1,1,0,NEU
dabrafenib_10uM_24h,dabrafenib,10 uM,24 h,3,65,68,1,6,6,0,NEU
acadesine_10uM_6h,acadesine,10 uM,6 h,3,29,32,1,0,0,0,NEU
AR-A014418_10uM_6h,AR-A014418,10 uM,6 h,3,29,32,1,1,1,0,NEU
apafant_10uM_24h,apafant,10 uM,24 h,3,32,35,1,0,0,0,NEU
lovastatin_10uM_6h,lovastatin,10 uM,6 h,3,47,50,1,0,0,0,NEU
nicotinamide_10uM_6h,nicotinamide,10 uM,6 h,3,29,32,1,0,0,0,NEU
trifluoperazine_10uM_24h,trifluoperazine,10 uM,24 h,3,24,27,1,22,8,14,NEU
pifithrin-mu_10uM_24h,pifithrin-mu,10 uM,24 h,3,25,28,1,93,29,64,NEU
puromycin_10uM_24h,puromycin,10 uM,24 h,3,32,35,1,0,0,0,NEU
PG-9_10uM_24h,PG-9,10 uM,24 h,3,32,35,1,0,0,0,NEU
oxyphenbutazone_10uM_6h,oxyphenbutazone,10 uM,6 h,3,47,50,1,49,34,15,NEU
bosutinib_10uM_6h,bosutinib,10 uM,6 h,3,29,32,1,19,11,8,NEU
thioperamide_10uM_6h,thioperamide,10 uM,6 h,3,47,50,1,2,1,1,NEU
GBR-12783_10uM_24h,GBR-12783,10 uM,24 h,3,32,35,1,3,2,1,NEU
ketanserin_10uM_24h,ketanserin,10 uM,24 h,3,32,35,1,1,0,1,NEU
isocarboxazid_10uM_24h,isocarboxazid,10 uM,24 h,3,32,35,1,0,0,0,NEU
pravastatin_10uM_6h,pravastatin,10 uM,6 h,3,47,50,1,0,0,0,NEU
acitretin_10uM_6h,acitretin,10 uM,6 h,3,29,32,1,4,1,3,NEU
ciproxifan_10uM_6h,ciproxifan,10 uM,6 h,3,47,50,1,0,0,0,NEU
10-DEBC_10uM_6h,10-DEBC,10 uM,6 h,3,29,32,1,14,11,3,NEU
scopolamine_10uM_24h,scopolamine,10 uM,24 h,3,32,35,1,0,0,0,NEU
suramin_10uM_24h,suramin,10 uM,24 h,3,25,28,1,0,0,0,NEU
metformin_10uM_6h,metformin,10 uM,6 h,3,29,32,1,0,0,0,NEU
foxy-5_10uM_24h,foxy-5,10 uM,24 h,3,24,27,1,0,0,0,NEU
ouabain_10uM_24h,ouabain,10 uM,24 h,3,32,35,1,129,55,74,NEU
trap-101_10uM_24h,trap-101,10 uM,24 h,3,32,35,1,0,0,0,NEU
DMP-543_10uM_24h,DMP-543,10 uM,24 h,3,32,35,1,0,0,0,NEU
NNC-63-0532_10uM_24h,NNC-63-0532,10 uM,24 h,3,32,35,1,0,0,0,NEU
GW-5074_10uM_24h,GW-5074,10 uM,24 h,3,65,68,1,0,0,0,NEU
sunitinib_10uM_24h,sunitinib,10 uM,24 h,3,41,44,2,37,15,22,NEU
cerulenin_10uM_24h,cerulenin,10 uM,24 h,3,25,28,1,16,4,12,NEU
PP-2_10uM_24h,PP-2,10 uM,24 h,3,24,27,1,0,0,0,NEU
BP-554_10uM_24h,BP-554,10 uM,24 h,3,32,35,1,0,0,0,NEU
sorafenib_10uM_6h,sorafenib,10 uM,6 h,3,29,32,1,10,2,8,NEU
etoposide_10uM_24h,etoposide,10 uM,24 h,3,24,27,1,216,81,135,NEU
azacyclonol_10uM_24h,azacyclonol,10 uM,24 h,3,32,35,1,0,0,0,NEU
SMER-28_10uM_6h,SMER-28,10 uM,6 h,3,29,32,1,0,0,0,NEU
pioglitazone_10uM_24h,pioglitazone,10 uM,24 h,3,24,27,1,114,67,47,NEU
caffeine_10uM_6h,caffeine,10 uM,6 h,3,29,32,1,0,0,0,NEU
FH-535_10uM_24h,FH-535,10 uM,24 h,3,24,27,1,3,0,3,NEU
NVP-BHG712_10uM_24h,NVP-BHG712,10 uM,24 h,3,65,68,1,2,1,1,NEU
moxonidine_10uM_24h,moxonidine,10 uM,24 h,3,32,35,1,0,0,0,NEU
benperidol_10uM_24h,benperidol,10 uM,24 h,3,32,35,1,0,0,0,NEU
vincristine_10uM_24h,vincristine,10 uM,24 h,3,32,35,1,60,16,44,NEU
ephedrine_10uM_24h,ephedrine,10 uM,24 h,3,25,28,1,0,0,0,NEU
pifithrin-mu_10uM_6h,pifithrin-mu,10 uM,6 h,3,47,50,1,15,15,0,NEU
pirinixic-acid_10uM_24h,pirinixic-acid,10 uM,24 h,3,24,27,1,198,60,138,NEU
BW-723C86_10uM_24h,BW-723C86,10 uM,24 h,3,32,35,1,0,0,0,NEU
tomelukast_10uM_24h,tomelukast,10 uM,24 h,3,24,27,1,0,0,0,NEU
SIB-1553A_10uM_6h,SIB-1553A,10 uM,6 h,3,47,50,1,7,4,3,NEU
clocortolone-pivalate_10uM_24h,clocortolone-pivalate,10 uM,24 h,3,32,35,1,0,0,0,NEU
phenothiazine_10uM_6h,phenothiazine,10 uM,6 h,3,47,50,1,0,0,0,NEU
GW-7647_10uM_24h,GW-7647,10 uM,24 h,3,24,27,1,117,30,87,NEU
reboxetine_10uM_24h,reboxetine,10 uM,24 h,3,25,28,1,27,15,12,NEU
C-1_10uM_24h,C-1,10 uM,24 h,3,32,35,1,0,0,0,NEU
fluoxetine_10uM_24h,fluoxetine,10 uM,24 h,3,25,28,1,2,0,2,NEU
YM-298198_10uM_6h,YM-298198,10 uM,6 h,3,47,50,1,1,1,0,NEU
RS-45041-190_10uM_24h,RS-45041-190,10 uM,24 h,3,32,35,1,0,0,0,NEU
6-aminochrysene_10uM_24h,6-aminochrysene,10 uM,24 h,3,32,35,1,0,0,0,NEU
bezafibrate_10uM_24h,bezafibrate,10 uM,24 h,3,24,27,1,0,0,0,NEU
progesterone_10uM_6h,progesterone,10 uM,6 h,3,29,32,1,0,0,0,NEU
cholic-acid_10uM_6h,cholic-acid,10 uM,6 h,3,29,32,1,0,0,0,NEU
ciglitazone_10uM_6h,ciglitazone,10 uM,6 h,3,29,32,1,0,0,0,NEU
icosapent_10uM_6h,icosapent,10 uM,6 h,3,29,32,1,0,0,0,NEU
alrestatin_10uM_24h,alrestatin,10 uM,24 h,3,32,35,1,2,1,1,NEU
propoxycaine_10uM_24h,propoxycaine,10 uM,24 h,3,32,35,1,1,0,1,NEU
SANT-1_10uM_24h,SANT-1,10 uM,24 h,3,32,35,1,0,0,0,NEU
nisoxetine_10uM_6h,nisoxetine,10 uM,6 h,3,47,50,1,1,1,0,NEU
NVP-BEZ235_10uM_24h,NVP-BEZ235,10 uM,24 h,3,24,27,1,170,37,133,NEU
luzindole_10uM_6h,luzindole,10 uM,6 h,3,47,50,1,0,0,0,NEU
SB-366791_10uM_24h,SB-366791,10 uM,24 h,3,32,35,1,0,0,0,NEU
carmoxirole_10uM_24h,carmoxirole,10 uM,24 h,3,32,35,1,2,2,0,NEU
plumbagin_10uM_6h,plumbagin,10 uM,6 h,3,29,32,1,203,68,135,NEU
CGS-21680_10uM_6h,CGS-21680,10 uM,6 h,3,47,50,1,0,0,0,NEU
gallic-acid_10uM_6h,gallic-acid,10 uM,6 h,3,29,32,1,24,18,6,NEU
butabindide_10uM_24h,butabindide,10 uM,24 h,3,32,35,1,1,1,0,NEU
CP-94253_10uM_24h,CP-94253,10 uM,24 h,3,32,35,1,1,1,0,NEU
tomelukast_10uM_6h,tomelukast,10 uM,6 h,3,29,32,1,0,0,0,NEU
NO-ASA_10uM_6h,NO-ASA,10 uM,6 h,3,29,32,1,114,49,65,NEU
PD-123319_10uM_24h,PD-123319,10 uM,24 h,3,32,35,1,0,0,0,NEU
loxapine_10uM_24h,loxapine,10 uM,24 h,3,32,35,1,0,0,0,NEU
Ro-04-5595_10uM_24h,Ro-04-5595,10 uM,24 h,3,32,35,1,8,2,6,NEU
salicin_10uM_24h,salicin,10 uM,24 h,3,32,35,1,1,1,0,NEU
bromocriptine_10uM_24h,bromocriptine,10 uM,24 h,3,32,35,1,0,0,0,NEU
chloroxine_10uM_24h,chloroxine,10 uM,24 h,3,32,35,1,4,2,2,NEU
spermidine_10uM_24h,spermidine,10 uM,24 h,3,24,27,1,0,0,0,NEU
GW-843682X_10uM_24h,GW-843682X,10 uM,24 h,3,32,35,1,9,5,4,NEU
ABC-294640_10uM_24h,ABC-294640,10 uM,24 h,3,24,27,1,2,1,1,NEU
zacopride_10uM_24h,zacopride,10 uM,24 h,3,25,28,1,0,0,0,NEU
endo-IWR-1_10uM_24h,endo-IWR-1,10 uM,24 h,3,24,27,1,56,18,38,NEU
saracatinib_10uM_24h,saracatinib,10 uM,24 h,3,28,31,2,3,1,2,NEU
SKF-89976A_10uM_24h,SKF-89976A,10 uM,24 h,3,32,35,1,2,1,1,NEU
cycloheximide_10uM_24h,cycloheximide,10 uM,24 h,3,25,28,1,133,93,40,NEU
MGCD-265_10uM_24h,MGCD-265,10 uM,24 h,3,65,68,1,0,0,0,NEU
erythromycin-estolate_10uM_24h,erythromycin-estolate,10 uM,24 h,3,32,35,1,1,1,0,NEU
SR-27897_10uM_24h,SR-27897,10 uM,24 h,3,32,35,1,4,3,1,NEU
tenoxicam_10uM_24h,tenoxicam,10 uM,24 h,3,32,35,1,0,0,0,NEU
carbamazepine_10uM_6h,carbamazepine,10 uM,6 h,3,29,32,1,0,0,0,NEU
aniracetam_10uM_6h,aniracetam,10 uM,6 h,3,47,50,1,3,2,1,NEU
TWS-119_10uM_6h,TWS-119,10 uM,6 h,3,29,32,1,4,1,3,NEU
rosiglitazone_10uM_6h,rosiglitazone,10 uM,6 h,3,29,32,1,0,0,0,NEU
desmethylclozapine_10uM_24h,desmethylclozapine,10 uM,24 h,3,32,35,1,0,0,0,NEU
FR-122047_10uM_24h,FR-122047,10 uM,24 h,3,32,35,1,0,0,0,NEU
isotretinoin_10uM_6h,isotretinoin,10 uM,6 h,3,29,32,1,0,0,0,NEU
AR-A014418_10uM_24h,AR-A014418,10 uM,24 h,3,24,27,1,14,6,8,NEU
metformin_10uM_24h,metformin,10 uM,24 h,3,24,27,1,1,0,1,NEU
tolcapone_10uM_24h,tolcapone,10 uM,24 h,3,25,28,1,1,1,0,NEU
naltrindole_10uM_24h,naltrindole,10 uM,24 h,3,32,35,1,0,0,0,NEU
EXO-1_10uM_24h,EXO-1,10 uM,24 h,3,32,35,1,0,0,0,NEU
xaliproden_10uM_24h,xaliproden,10 uM,24 h,3,32,35,1,3,1,2,NEU
cyclopiazonic-acid_10uM_24h,cyclopiazonic-acid,10 uM,24 h,3,32,35,1,0,0,0,NEU
spironolactone_10uM_24h,spironolactone,10 uM,24 h,3,32,35,1,50,21,29,NEU
clopidogrel_10uM_6h,clopidogrel,10 uM,6 h,3,47,50,1,1,1,0,NEU
quercetin_10uM_6h,quercetin,10 uM,6 h,3,29,32,1,0,0,0,NEU
pinacidil_10uM_24h,pinacidil,10 uM,24 h,3,32,35,1,1,1,0,NEU
devazepide_10uM_24h,devazepide,10 uM,24 h,3,32,35,1,2,1,1,NEU
benzonatate_10uM_24h,benzonatate,10 uM,24 h,3,32,35,1,3,1,2,NEU
icosapent_10uM_24h,icosapent,10 uM,24 h,3,24,27,1,0,0,0,NEU
FR-139317_10uM_24h,FR-139317,10 uM,24 h,3,32,35,1,0,0,0,NEU
CGP-37157_10uM_24h,CGP-37157,10 uM,24 h,3,32,35,1,0,0,0,NEU
CI-966_10uM_24h,CI-966,10 uM,24 h,3,32,35,1,2,1,1,NEU
quinidine_10uM_6h,quinidine,10 uM,6 h,3,29,32,1,0,0,0,NEU
SDZ-205-557_10uM_24h,SDZ-205-557,10 uM,24 h,3,32,35,1,0,0,0,NEU
SB-200646_10uM_24h,SB-200646,10 uM,24 h,3,32,35,1,0,0,0,NEU
brucine_10uM_24h,brucine,10 uM,24 h,3,32,35,1,3,2,1,NEU
oxyphenbutazone_10uM_24h,oxyphenbutazone,10 uM,24 h,3,25,28,1,103,36,67,NEU
thalidomide_10uM_24h,thalidomide,10 uM,24 h,3,24,27,1,1,1,0,NEU
dinoprostone_10uM_6h,dinoprostone,10 uM,6 h,3,29,32,1,0,0,0,NEU
L-690330_10uM_24h,L-690330,10 uM,24 h,3,24,27,1,11,3,8,NEU
phenylbutyrate_10uM_6h,phenylbutyrate,10 uM,6 h,3,29,32,1,0,0,0,NEU
ellagic-acid_10uM_24h,ellagic-acid,10 uM,24 h,3,24,27,1,0,0,0,NEU
BMS-191011_10uM_24h,BMS-191011,10 uM,24 h,3,32,35,1,0,0,0,NEU
GTP-14564_10uM_24h,GTP-14564,10 uM,24 h,3,32,35,1,0,0,0,NEU
TWS-119_10uM_24h,TWS-119,10 uM,24 h,3,24,27,1,46,12,34,NEU
SKF-81297_10uM_24h,SKF-81297,10 uM,24 h,3,25,28,1,1,0,1,NEU
FPL-55712_10uM_24h,FPL-55712,10 uM,24 h,3,32,35,1,0,0,0,NEU
exifone_10uM_24h,exifone,10 uM,24 h,3,24,27,1,1,0,1,NEU
BRL-54443_10uM_24h,BRL-54443,10 uM,24 h,3,32,35,1,0,0,0,NEU
gliquidone_10uM_24h,gliquidone,10 uM,24 h,3,32,35,1,0,0,0,NEU
desoxycortone_10uM_24h,desoxycortone,10 uM,24 h,3,32,35,1,0,0,0,NEU
PD-98059_10uM_24h,PD-98059,10 uM,24 h,3,24,27,1,9,1,8,NEU
kaempferol_10uM_24h,kaempferol,10 uM,24 h,3,25,28,1,0,0,0,NEU
acadesine_10uM_24h,acadesine,10 uM,24 h,3,24,27,1,26,5,21,NEU
sirolimus_10uM_6h,sirolimus,10 uM,6 h,3,29,32,1,1,0,1,NEU
GGTI-298_10uM_6h,GGTI-298,10 uM,6 h,3,47,50,1,0,0,0,NEU
FH-535_10uM_6h,FH-535,10 uM,6 h,3,29,32,1,0,0,0,NEU
BML-284_10uM_6h,BML-284,10 uM,6 h,3,29,32,1,12,11,1,NEU
clorgiline_10uM_6h,clorgiline,10 uM,6 h,3,47,50,1,2,2,0,NEU
adapalene_10uM_6h,adapalene,10 uM,6 h,3,29,32,1,0,0,0,NEU
RN-1_10uM_24h,RN-1,10 uM,24 h,3,25,28,1,4,1,3,NEU
CL-218872_10uM_24h,CL-218872,10 uM,24 h,3,32,35,1,0,0,0,NEU
mofezolac_10uM_24h,mofezolac,10 uM,24 h,3,32,35,1,0,0,0,NEU
BAY-61-3606_10uM_24h,BAY-61-3606,10 uM,24 h,3,65,68,1,35,23,12,NEU
RS-16566_10uM_24h,RS-16566,10 uM,24 h,3,32,35,1,1,1,0,NEU
A-769662_10uM_24h,A-769662,10 uM,24 h,3,65,68,1,7,3,4,NEU
phenylbutyrate_10uM_24h,phenylbutyrate,10 uM,24 h,3,24,27,1,0,0,0,NEU
JNJ-16259685_10uM_6h,JNJ-16259685,10 uM,6 h,3,47,50,1,1,1,0,NEU
talipexole_10uM_24h,talipexole,10 uM,24 h,3,32,35,1,0,0,0,NEU
TNP-470_10uM_24h,TNP-470,10 uM,24 h,3,24,27,1,94,25,69,NEU
procaterol_10uM_24h,procaterol,10 uM,24 h,3,32,35,1,0,0,0,NEU
EX-527_10uM_6h,EX-527,10 uM,6 h,3,29,32,1,0,0,0,NEU
thioperamide_10uM_24h,thioperamide,10 uM,24 h,3,25,28,1,0,0,0,NEU
pirfenidone_10uM_24h,pirfenidone,10 uM,24 h,3,32,35,1,4,2,2,NEU
danazol_10uM_24h,danazol,10 uM,24 h,3,32,35,1,2,1,1,NEU
L-689560_10uM_24h,L-689560,10 uM,24 h,3,32,35,1,0,0,0,NEU
tropisetron_10uM_24h,tropisetron,10 uM,24 h,3,32,35,1,1,1,0,NEU
AZ-628_10uM_24h,AZ-628,10 uM,24 h,3,41,44,2,9,2,7,NEU
WAY-100635_10uM_6h,WAY-100635,10 uM,6 h,3,47,50,1,0,0,0,NEU
pioglitazone_10uM_6h,pioglitazone,10 uM,6 h,3,29,32,1,1,0,1,NEU
mianserin_10uM_24h,mianserin,10 uM,24 h,3,32,35,1,16,3,13,NEU
droperidol_10uM_24h,droperidol,10 uM,24 h,3,32,35,1,3,2,1,NEU
KN-93_10uM_24h,KN-93,10 uM,24 h,3,32,35,1,3,3,0,NEU
SB-218078_10uM_24h,SB-218078,10 uM,24 h,3,32,35,1,9,7,2,NEU
RHC-80267_10uM_24h,RHC-80267,10 uM,24 h,3,32,35,1,83,36,47,NEU
cyanopindolol_10uM_6h,cyanopindolol,10 uM,6 h,3,47,50,1,7,5,2,NEU
D-4476_10uM_6h,D-4476,10 uM,6 h,3,29,32,1,1,0,1,NEU
SB-525334_10uM_24h,SB-525334,10 uM,24 h,3,41,44,2,8,6,2,NEU
NTNCB_10uM_24h,NTNCB,10 uM,24 h,3,32,35,1,5,3,2,NEU
diclofenac_10uM_6h,diclofenac,10 uM,6 h,3,29,32,1,0,0,0,NEU
BRL-50481_10uM_24h,BRL-50481,10 uM,24 h,3,32,35,1,0,0,0,NEU
DNQX_10uM_24h,DNQX,10 uM,24 h,3,32,35,1,1,0,1,NEU
CP-93129_10uM_24h,CP-93129,10 uM,24 h,3,32,35,1,0,0,0,NEU
cyanopindolol_10uM_24h,cyanopindolol,10 uM,24 h,3,25,28,1,1,0,1,NEU
caffeine_10uM_24h,caffeine,10 uM,24 h,3,24,27,1,15,11,4,NEU
zacopride_10uM_6h,zacopride,10 uM,6 h,3,47,50,1,0,0,0,NEU
piretanide_10uM_24h,piretanide,10 uM,24 h,3,32,35,1,0,0,0,NEU
pimozide_10uM_6h,pimozide,10 uM,6 h,3,29,32,1,0,0,0,NEU
minoxidil_10uM_24h,minoxidil,10 uM,24 h,3,24,27,1,1,0,1,NEU
regorafenib_10uM_24h,regorafenib,10 uM,24 h,3,65,68,1,62,42,20,NEU
estrone_10uM_24h,estrone,10 uM,24 h,3,24,27,1,1,1,0,NEU
amiodarone_10uM_24h,amiodarone,10 uM,24 h,3,24,27,1,552,215,337,NEU
M-344_10uM_6h,M-344,10 uM,6 h,3,29,32,1,117,68,49,NEU
isradipine_10uM_24h,isradipine,10 uM,24 h,3,25,28,1,4,1,3,NEU
flunarizine_10uM_24h,flunarizine,10 uM,24 h,3,32,35,1,10,0,10,NEU
suramin_10uM_6h,suramin,10 uM,6 h,3,47,50,1,6,6,0,NEU
CGP-13501_10uM_24h,CGP-13501,10 uM,24 h,3,32,35,1,0,0,0,NEU
ciglitazone_10uM_24h,ciglitazone,10 uM,24 h,3,24,27,1,16,1,15,NEU
zebularine_10uM_6h,zebularine,10 uM,6 h,3,29,32,1,2,0,2,NEU
CITCO_10uM_6h,CITCO,10 uM,6 h,3,29,32,1,0,0,0,NEU
caffeic-acid_10uM_24h,caffeic-acid,10 uM,24 h,3,32,35,1,12,7,5,NEU
octopamine_10uM_24h,octopamine,10 uM,24 h,3,25,28,1,0,0,0,NEU
zebularine_10uM_24h,zebularine,10 uM,24 h,3,24,27,1,2,2,0,NEU
beclomethasone-dipropionate_10uM_24h,beclomethasone-dipropionate,10 uM,24 h,3,32,35,1,0,0,0,NEU
bifemelane_10uM_24h,bifemelane,10 uM,24 h,3,32,35,1,0,0,0,NEU
rilmenidine_10uM_6h,rilmenidine,10 uM,6 h,3,29,32,1,0,0,0,NEU
kaempferol_10uM_6h,kaempferol,10 uM,6 h,3,47,50,1,1,0,1,NEU
cilastatin_10uM_24h,cilastatin,10 uM,24 h,3,32,35,1,0,0,0,NEU
pivmecillinam_10uM_24h,pivmecillinam,10 uM,24 h,3,32,35,1,7,4,3,NEU
NO-ASA_10uM_24h,NO-ASA,10 uM,24 h,3,24,27,1,438,147,291,NEU
RU-24969_10uM_6h,RU-24969,10 uM,6 h,3,47,50,1,2,2,0,NEU
Ro-60-0175_10uM_24h,Ro-60-0175,10 uM,24 h,3,32,35,1,0,0,0,NEU
flutamide_10uM_24h,flutamide,10 uM,24 h,3,32,35,1,0,0,0,NEU
nocodazole_10uM_24h,nocodazole,10 uM,24 h,3,25,28,1,75,31,44,NEU
SIB-1553A_10uM_24h,SIB-1553A,10 uM,24 h,3,25,28,1,1,0,1,NEU
SB-408124_10uM_24h,SB-408124,10 uM,24 h,3,32,35,1,20,6,14,NEU
raclopride_10uM_24h,raclopride,10 uM,24 h,3,32,35,1,0,0,0,NEU
lamotrigine_10uM_24h,lamotrigine,10 uM,24 h,3,32,35,1,0,0,0,NEU
chloroquine_10uM_24h,chloroquine,10 uM,24 h,3,24,27,1,14,3,11,NEU
ABC-294640_10uM_6h,ABC-294640,10 uM,6 h,3,29,32,1,0,0,0,NEU
nimodipine_10uM_24h,nimodipine,10 uM,24 h,3,24,27,1,1,0,1,NEU
quercetin_10uM_24h,quercetin,10 uM,24 h,3,24,27,1,6,0,6,NEU
GW-4064_10uM_6h,GW-4064,10 uM,6 h,3,29,32,1,0,0,0,NEU
gabazine_10uM_24h,gabazine,10 uM,24 h,3,32,35,1,0,0,0,NEU
trapidil_10uM_24h,trapidil,10 uM,24 h,3,32,35,1,0,0,0,NEU
spermidine_10uM_6h,spermidine,10 uM,6 h,3,29,32,1,0,0,0,NEU
NSC-3852_10uM_6h,NSC-3852,10 uM,6 h,3,29,32,1,30,16,14,NEU
DPPE_10uM_24h,DPPE,10 uM,24 h,3,32,35,1,0,0,0,NEU
nisoxetine_10uM_24h,nisoxetine,10 uM,24 h,3,25,28,1,2,2,0,NEU
PI-103_10uM_24h,PI-103,10 uM,24 h,3,24,27,1,387,122,265,NEU
AM-630_10uM_24h,AM-630,10 uM,24 h,3,32,35,1,0,0,0,NEU
semaxanib_10uM_24h,semaxanib,10 uM,24 h,3,32,35,1,83,33,50,NEU
anisomycin_10uM_6h,anisomycin,10 uM,6 h,3,29,32,1,110,78,32,NEU
ciproxifan_10uM_24h,ciproxifan,10 uM,24 h,3,25,28,1,6,2,4,NEU
etoposide_10uM_6h,etoposide,10 uM,6 h,3,29,32,1,8,5,3,NEU
rimonabant_10uM_24h,rimonabant,10 uM,24 h,3,25,28,1,71,19,52,NEU
cefixime_10uM_24h,cefixime,10 uM,24 h,3,32,35,1,1,1,0,NEU
calcitriol_10uM_6h,calcitriol,10 uM,6 h,3,29,32,1,0,0,0,NEU
adapalene_10uM_24h,adapalene,10 uM,24 h,3,24,27,1,1,1,0,NEU
octopamine_10uM_6h,octopamine,10 uM,6 h,3,47,50,1,1,1,0,NEU
amiodarone_10uM_6h,amiodarone,10 uM,6 h,3,29,32,1,30,18,12,NEU
NNC-05-2090_10uM_24h,NNC-05-2090,10 uM,24 h,3,32,35,1,47,8,39,NEU
imiquimod_10uM_24h,imiquimod,10 uM,24 h,3,24,27,1,4,3,1,NEU
apigenin_10uM_6h,apigenin,10 uM,6 h,3,29,32,1,0,0,0,NEU
cromakalim_10uM_24h,cromakalim,10 uM,24 h,3,32,35,1,0,0,0,NEU
relcovaptan_10uM_24h,relcovaptan,10 uM,24 h,3,32,35,1,0,0,0,NEU
PD-98059_10uM_6h,PD-98059,10 uM,6 h,3,29,32,1,0,0,0,NEU
PI-103_10uM_6h,PI-103,10 uM,6 h,3,29,32,1,2,0,2,NEU
AM-580_10uM_6h,AM-580,10 uM,6 h,3,29,32,1,0,0,0,NEU
vanoxerine_10uM_6h,vanoxerine,10 uM,6 h,3,47,50,1,40,25,15,NEU
nimodipine_10uM_6h,nimodipine,10 uM,6 h,3,29,32,1,0,0,0,NEU
hexachlorophene_10uM_24h,hexachlorophene,10 uM,24 h,3,24,27,1,138,47,91,NEU
nitrendipine_10uM_6h,nitrendipine,10 uM,6 h,3,29,32,1,0,0,0,NEU
MG-132_10uM_6h,MG-132,10 uM,6 h,3,29,32,1,55,38,17,NEU
ZM-306416_10uM_24h,ZM-306416,10 uM,24 h,3,32,35,1,1,0,1,NEU
rimexolone_10uM_24h,rimexolone,10 uM,24 h,3,32,35,1,0,0,0,NEU
CC-401_10uM_24h,CC-401,10 uM,24 h,3,65,68,1,2,1,1,NEU
clozapine_10uM_6h,clozapine,10 uM,6 h,3,47,50,1,1,1,0,NEU
tolazamide_10uM_6h,tolazamide,10 uM,6 h,3,29,32,1,1,0,1,NEU
temozolomide_10uM_24h,temozolomide,10 uM,24 h,3,24,27,1,188,79,109,NEU
STF-62247_10uM_24h,STF-62247,10 uM,24 h,3,24,27,1,7,5,2,NEU
gemfibrozil_10uM_6h,gemfibrozil,10 uM,6 h,3,29,32,1,0,0,0,NEU
cortisone_10uM_24h,cortisone,10 uM,24 h,3,24,27,1,0,0,0,NEU
foxy-5_10uM_6h,foxy-5,10 uM,6 h,3,29,32,1,1,0,1,NEU
L-655240_10uM_24h,L-655240,10 uM,24 h,3,32,35,1,1,1,0,NEU
cortisone_10uM_6h,cortisone,10 uM,6 h,3,29,32,1,3,2,1,NEU
MPEP_10uM_6h,MPEP,10 uM,6 h,3,47,50,1,0,0,0,NEU
arctigenin_10uM_24h,arctigenin,10 uM,24 h,3,32,35,1,0,0,0,NEU
luzindole_10uM_24h,luzindole,10 uM,24 h,3,25,28,1,300,113,187,NEU
CITCO_10uM_24h,CITCO,10 uM,24 h,3,24,27,1,63,18,45,NEU
lovastatin_10uM_24h,lovastatin,10 uM,24 h,3,25,28,1,2,1,1,NEU
reboxetine_10uM_6h,reboxetine,10 uM,6 h,3,47,50,1,1,1,0,NEU
GDC-0941_10uM_24h,GDC-0941,10 uM,24 h,3,20,23,1,0,0,0,NEU
budesonide_10uM_24h,budesonide,10 uM,24 h,3,32,35,1,11,2,9,NEU
altretamine_10uM_24h,altretamine,10 uM,24 h,3,32,35,1,5,3,2,NEU
SDZ-NKT-343_10uM_24h,SDZ-NKT-343,10 uM,24 h,3,32,35,1,0,0,0,NEU
riboflavin_10uM_24h,riboflavin,10 uM,24 h,3,32,35,1,0,0,0,NEU
RS-504393_10uM_24h,RS-504393,10 uM,24 h,3,32,35,1,0,0,0,NEU
fenobam_10uM_6h,fenobam,10 uM,6 h,3,47,50,1,5,4,1,NEU
trifluridine_10uM_6h,trifluridine,10 uM,6 h,3,47,50,1,0,0,0,NEU
dinoprostone_10uM_24h,dinoprostone,10 uM,24 h,3,24,27,1,47,20,27,NEU
fluspirilene_10uM_24h,fluspirilene,10 uM,24 h,3,24,27,1,19,6,13,NEU
masitinib_10uM_24h,masitinib,10 uM,24 h,3,41,44,2,6,3,3,NEU
mevastatin_10uM_6h,mevastatin,10 uM,6 h,3,47,50,1,4,2,2,NEU
alpha-methylserotonin_10uM_24h,alpha-methylserotonin,10 uM,24 h,3,25,28,1,1,0,1,NEU
CPCCOEt_10uM_24h,CPCCOEt,10 uM,24 h,3,25,28,1,107,32,75,NEU
nocodazole_10uM_6h,nocodazole,10 uM,6 h,3,47,50,1,22,20,2,NEU
endo-IWR-1_10uM_6h,endo-IWR-1,10 uM,6 h,3,29,32,1,4,2,2,NEU
melperone_10uM_24h,melperone,10 uM,24 h,3,32,35,1,0,0,0,NEU
mirtazapine_10uM_24h,mirtazapine,10 uM,24 h,3,32,35,1,2,1,1,NEU
AM-580_10uM_24h,AM-580,10 uM,24 h,3,24,27,1,68,27,41,NEU
guanaben-acetate_10uM_24h,guanaben-acetate,10 uM,24 h,3,32,35,1,1,1,0,NEU
nimesulide_10uM_24h,nimesulide,10 uM,24 h,3,32,35,1,0,0,0,NEU
terconazole_10uM_24h,terconazole,10 uM,24 h,3,32,35,1,1,1,0,NEU
CS-110266_10uM_6h,CS-110266,10 uM,6 h,3,47,50,1,0,0,0,NEU
AM-251_10uM_24h,AM-251,10 uM,24 h,3,32,35,1,0,0,0,NEU
ZM-323881_10uM_24h,ZM-323881,10 uM,24 h,3,32,35,1,0,0,0,NEU
CGS-20625_10uM_24h,CGS-20625,10 uM,24 h,3,32,35,1,0,0,0,NEU
tolcapone_10uM_6h,tolcapone,10 uM,6 h,3,47,50,1,4,4,0,NEU
vanoxerine_10uM_24h,vanoxerine,10 uM,24 h,3,25,28,1,2,2,0,NEU
celecoxib_10uM_6h,celecoxib,10 uM,6 h,3,29,32,1,24,14,10,NEU
SC-9_10uM_24h,SC-9,10 uM,24 h,3,32,35,1,0,0,0,NEU
everolimus_10uM_24h,everolimus,10 uM,24 h,3,41,44,2,0,0,0,NEU
PF-573228_10uM_24h,PF-573228,10 uM,24 h,3,65,68,1,0,0,0,NEU
fenoterol_10uM_24h,fenoterol,10 uM,24 h,3,32,35,1,0,0,0,NEU
PCI-34051_10uM_24h,PCI-34051,10 uM,24 h,3,24,27,1,0,0,0,NEU
SKF-77434_10uM_24h,SKF-77434,10 uM,24 h,3,32,35,1,3,3,0,NEU
RS-102221_10uM_24h,RS-102221,10 uM,24 h,3,32,35,1,0,0,0,NEU
pterostilbene_10uM_24h,pterostilbene,10 uM,24 h,3,24,27,1,1,0,1,NEU
AQ-RA741_10uM_24h,AQ-RA741,10 uM,24 h,3,32,35,1,0,0,0,NEU
clofibric-acid_10uM_6h,clofibric-acid,10 uM,6 h,3,29,32,1,0,0,0,NEU
kenpaullone_10uM_6h,kenpaullone,10 uM,6 h,3,29,32,1,0,0,0,NEU
SMER-28_10uM_24h,SMER-28,10 uM,24 h,3,24,27,1,8,4,4,NEU
DR-2313_10uM_24h,DR-2313,10 uM,24 h,3,32,35,1,4,2,2,NEU
rimcazole_10uM_24h,rimcazole,10 uM,24 h,3,32,35,1,9,4,5,NEU
panobinostat_10uM_24h,panobinostat,10 uM,24 h,3,32,35,1,159,66,93,NEU
BADGE_10uM_6h,BADGE,10 uM,6 h,3,29,32,1,0,0,0,NEU
clonidine_10uM_6h,clonidine,10 uM,6 h,3,29,32,1,0,0,0,NEU
noretynodrel_10uM_24h,noretynodrel,10 uM,24 h,3,32,35,1,0,0,0,NEU
hydroxychloroquine_10uM_24h,hydroxychloroquine,10 uM,24 h,3,24,27,1,3,0,3,NEU
estrone_10uM_6h,estrone,10 uM,6 h,3,29,32,1,1,1,0,NEU
anandamide_10uM_6h,anandamide,10 uM,6 h,3,29,32,1,1,1,0,NEU
aminopurvalanol-a_10uM_24h,aminopurvalanol-a,10 uM,24 h,3,32,35,1,104,23,81,NEU
pyrazolanthrone_10uM_6h,pyrazolanthrone,10 uM,6 h,3,29,32,1,0,0,0,NEU
TTNPB_10uM_6h,TTNPB,10 uM,6 h,3,29,32,1,0,0,0,NEU
nicergoline_10uM_24h,nicergoline,10 uM,24 h,3,32,35,1,1,0,1,NEU
exifone_10uM_6h,exifone,10 uM,6 h,3,29,32,1,0,0,0,NEU
bemesetron_10uM_24h,bemesetron,10 uM,24 h,3,32,35,1,2,1,1,NEU
cycloheximide_10uM_6h,cycloheximide,10 uM,6 h,3,47,50,1,84,69,15,NEU
loperamide_10uM_24h,loperamide,10 uM,24 h,3,24,27,1,3,3,0,NEU
PCI-34051_10uM_6h,PCI-34051,10 uM,6 h,3,29,32,1,0,0,0,NEU
clopidogrel_10uM_24h,clopidogrel,10 uM,24 h,3,25,28,1,0,0,0,NEU
nitrocaramiphen_10uM_24h,nitrocaramiphen,10 uM,24 h,3,32,35,1,1,0,1,NEU
thiethylperazine_10uM_24h,thiethylperazine,10 uM,24 h,3,32,35,1,1,1,0,NEU
SB-216641_10uM_24h,SB-216641,10 uM,24 h,3,32,35,1,0,0,0,NEU
Ro-19-4605_10uM_24h,Ro-19-4605,10 uM,24 h,3,32,35,1,2,2,0,NEU
fluoxetine_10uM_6h,fluoxetine,10 uM,6 h,3,47,50,1,1,0,1,NEU
fluvastatin_10uM_6h,fluvastatin,10 uM,6 h,3,47,50,1,3,2,1,NEU
rosiglitazone_10uM_24h,rosiglitazone,10 uM,24 h,3,24,27,1,0,0,0,NEU
chloroquine_10uM_6h,chloroquine,10 uM,6 h,3,29,32,1,1,0,1,NEU
noscapine_10uM_24h,noscapine,10 uM,24 h,3,32,35,1,0,0,0,NEU
proxymetacaine_10uM_24h,proxymetacaine,10 uM,24 h,3,32,35,1,0,0,0,NEU
pazopanib_10uM_24h,pazopanib,10 uM,24 h,3,41,44,2,14,10,4,NEU
temozolomide_10uM_6h,temozolomide,10 uM,6 h,3,29,32,1,13,8,5,NEU
pimozide_10uM_24h,pimozide,10 uM,24 h,3,24,27,1,13,5,8,NEU
rigosertib_10uM_24h,rigosertib,10 uM,24 h,3,65,68,1,8,5,3,NEU
PQ-401_10uM_24h,PQ-401,10 uM,24 h,3,32,35,1,8,5,3,NEU
epirubicin_10uM_6h,epirubicin,10 uM,6 h,3,29,32,1,155,36,119,NEU
monastrol_10uM_24h,monastrol,10 uM,24 h,3,32,35,1,1,0,1,NEU
RN-1_10uM_6h,RN-1,10 uM,6 h,3,47,50,1,5,3,2,NEU
naringenin_10uM_24h,naringenin,10 uM,24 h,3,32,35,1,0,0,0,NEU
phenothiazine_10uM_24h,phenothiazine,10 uM,24 h,3,25,28,1,1,1,0,NEU
alprenolol_10uM_24h,alprenolol,10 uM,24 h,3,32,35,1,3,1,2,NEU
pirinixic-acid_10uM_6h,pirinixic-acid,10 uM,6 h,3,29,32,1,0,0,0,NEU
flupentixol_10uM_24h,flupentixol,10 uM,24 h,3,32,35,1,1,1,0,NEU
gemfibrozil_10uM_24h,gemfibrozil,10 uM,24 h,3,24,27,1,0,0,0,NEU
ellagic-acid_10uM_6h,ellagic-acid,10 uM,6 h,3,29,32,1,1,0,1,NEU
fluvoxamine_10uM_24h,fluvoxamine,10 uM,24 h,3,32,35,1,3,2,1,NEU
capsaicin_10uM_6h,capsaicin,10 uM,6 h,3,29,32,1,0,0,0,NEU
atorvastatin_10uM_6h,atorvastatin,10 uM,6 h,3,47,50,1,0,0,0,NEU
nicotinamide_10uM_24h,nicotinamide,10 uM,24 h,3,24,27,1,4,2,2,NEU
U-99194_10uM_24h,U-99194,10 uM,24 h,3,32,35,1,0,0,0,NEU
NBI-27914_10uM_24h,NBI-27914,10 uM,24 h,3,32,35,1,22,12,10,NEU
flurofamide_10uM_24h,flurofamide,10 uM,24 h,3,32,35,1,0,0,0,NEU
PNU-74654_10uM_6h,PNU-74654,10 uM,6 h,3,29,32,1,0,0,0,NEU
givinostat_10uM_24h,givinostat,10 uM,24 h,3,32,35,1,4,2,2,NEU
rigosertib_0.04uM_24h,rigosertib,0.04 uM,24 h,3,65,68,1,0,0,0,NEU
TAK-715_0.04uM_24h,TAK-715,0.04 uM,24 h,3,65,68,1,0,0,0,NEU
ponatinib_0.04uM_24h,ponatinib,0.04 uM,24 h,3,65,68,1,17,8,9,NEU
serdemetan_0.04uM_24h,serdemetan,0.04 uM,24 h,3,65,68,1,3,3,0,NEU
JNJ-38877605_0.04uM_24h,JNJ-38877605,0.04 uM,24 h,3,65,68,1,0,0,0,NEU
GDC-0879_0.04uM_24h,GDC-0879,0.04 uM,24 h,3,65,68,1,0,0,0,NEU
dabrafenib_0.04uM_24h,dabrafenib,0.04 uM,24 h,3,65,68,1,4,4,0,NEU
SB-203580_0.04uM_24h,SB-203580,0.04 uM,24 h,3,65,68,1,0,0,0,NEU
PF-03758309_0.04uM_24h,PF-03758309,0.04 uM,24 h,3,65,68,1,6,2,4,NEU
ZM-447439_0.04uM_24h,ZM-447439,0.04 uM,24 h,3,65,68,1,2,1,1,NEU
regorafenib_0.04uM_24h,regorafenib,0.04 uM,24 h,3,65,68,1,0,0,0,NEU
PF-573228_0.04uM_24h,PF-573228,0.04 uM,24 h,3,65,68,1,0,0,0,NEU
HMN-214_0.04uM_24h,HMN-214,0.04 uM,24 h,3,65,68,1,2,2,0,NEU
NVP-BHG712_0.04uM_24h,NVP-BHG712,0.04 uM,24 h,3,65,68,1,0,0,0,NEU
VX-745_0.04uM_24h,VX-745,0.04 uM,24 h,3,65,68,1,8,5,3,NEU
GW-5074_0.04uM_24h,GW-5074,0.04 uM,24 h,3,65,68,1,3,2,1,NEU
A-769662_0.04uM_24h,A-769662,0.04 uM,24 h,3,65,68,1,0,0,0,NEU
GNF-2_0.04uM_24h,GNF-2,0.04 uM,24 h,3,65,68,1,1,1,0,NEU
BI-2536_0.04uM_24h,BI-2536,0.04 uM,24 h,3,65,68,1,3,2,1,NEU
D-4476_0.04uM_24h,D-4476,0.04 uM,24 h,3,65,68,1,0,0,0,NEU
SB-239063_0.04uM_24h,SB-239063,0.04 uM,24 h,3,65,68,1,1,0,1,NEU
CC-401_0.04uM_24h,CC-401,0.04 uM,24 h,3,65,68,1,0,0,0,NEU
BAY-61-3606_0.04uM_24h,BAY-61-3606,0.04 uM,24 h,3,65,68,1,4,3,1,NEU
KI-20227_0.04uM_24h,KI-20227,0.04 uM,24 h,3,65,68,1,0,0,0,NEU
dabrafenib_0.12uM_24h,dabrafenib,0.12 uM,24 h,3,65,68,1,1,1,0,NEU
CC-401_0.12uM_24h,CC-401,0.12 uM,24 h,3,65,68,1,1,1,0,NEU
JNJ-38877605_0.12uM_24h,JNJ-38877605,0.12 uM,24 h,3,65,68,1,1,0,1,NEU
saracatinib_0.12uM_24h,saracatinib,0.12 uM,24 h,3,65,68,1,0,0,0,NEU
PF-03758309_0.12uM_24h,PF-03758309,0.12 uM,24 h,3,65,68,1,19,15,4,NEU
rigosertib_0.12uM_24h,rigosertib,0.12 uM,24 h,3,65,68,1,2,2,0,NEU
BX-795_0.12uM_24h,BX-795,0.12 uM,24 h,3,65,68,1,1,1,0,NEU
serdemetan_0.12uM_24h,serdemetan,0.12 uM,24 h,3,65,68,1,5,0,5,NEU
HMN-214_0.12uM_24h,HMN-214,0.12 uM,24 h,3,65,68,1,2,2,0,NEU
KI-20227_0.12uM_24h,KI-20227,0.12 uM,24 h,3,65,68,1,1,0,1,NEU
GDC-0879_0.12uM_24h,GDC-0879,0.12 uM,24 h,3,65,68,1,0,0,0,NEU
A-769662_0.12uM_24h,A-769662,0.12 uM,24 h,3,65,68,1,0,0,0,NEU
GNF-2_0.12uM_24h,GNF-2,0.12 uM,24 h,3,65,68,1,1,1,0,NEU
GW-5074_0.12uM_24h,GW-5074,0.12 uM,24 h,3,65,68,1,3,2,1,NEU
SB-203580_0.12uM_24h,SB-203580,0.12 uM,24 h,3,65,68,1,16,5,11,NEU
SB-239063_0.12uM_24h,SB-239063,0.12 uM,24 h,3,65,68,1,0,0,0,NEU
TAK-715_0.12uM_24h,TAK-715,0.12 uM,24 h,3,65,68,1,1,1,0,NEU
alectinib_0.12uM_24h,alectinib,0.12 uM,24 h,3,65,68,1,0,0,0,NEU
PF-573228_0.12uM_24h,PF-573228,0.12 uM,24 h,3,65,68,1,1,1,0,NEU
D-4476_0.12uM_24h,D-4476,0.12 uM,24 h,3,65,68,1,2,1,1,NEU
NVP-BHG712_0.12uM_24h,NVP-BHG712,0.12 uM,24 h,3,65,68,1,1,1,0,NEU
VX-745_0.12uM_24h,VX-745,0.12 uM,24 h,3,65,68,1,3,0,3,NEU
regorafenib_0.12uM_24h,regorafenib,0.12 uM,24 h,3,65,68,1,0,0,0,NEU
BAY-61-3606_0.12uM_24h,BAY-61-3606,0.12 uM,24 h,3,65,68,1,0,0,0,NEU
MGCD-265_0.12uM_24h,MGCD-265,0.12 uM,24 h,3,65,68,1,0,0,0,NEU
CC-401_0.37uM_24h,CC-401,0.37 uM,24 h,3,65,68,1,2,1,1,NEU
KI-20227_0.37uM_24h,KI-20227,0.37 uM,24 h,3,65,68,1,3,2,1,NEU
alectinib_0.37uM_24h,alectinib,0.37 uM,24 h,3,65,68,1,5,3,2,NEU
SB-203580_0.37uM_24h,SB-203580,0.37 uM,24 h,3,65,68,1,2,1,1,NEU
A-769662_0.37uM_24h,A-769662,0.37 uM,24 h,3,65,68,1,1,0,1,NEU
SB-239063_0.37uM_24h,SB-239063,0.37 uM,24 h,3,65,68,1,0,0,0,NEU
dabrafenib_0.37uM_24h,dabrafenib,0.37 uM,24 h,3,65,68,1,2,2,0,NEU
GDC-0879_0.37uM_24h,GDC-0879,0.37 uM,24 h,3,65,68,1,4,3,1,NEU
BI-2536_0.37uM_24h,BI-2536,0.37 uM,24 h,3,65,68,1,2,0,2,NEU
saracatinib_0.37uM_24h,saracatinib,0.37 uM,24 h,3,65,68,1,3,3,0,NEU
MGCD-265_0.37uM_24h,MGCD-265,0.37 uM,24 h,3,65,68,1,0,0,0,NEU
pyrazolanthrone_0.37uM_24h,pyrazolanthrone,0.37 uM,24 h,3,65,68,1,3,3,0,NEU
rigosertib_0.37uM_24h,rigosertib,0.37 uM,24 h,3,65,68,1,3,2,1,NEU
ponatinib_0.37uM_24h,ponatinib,0.37 uM,24 h,3,65,68,1,3,2,1,NEU
PF-573228_0.37uM_24h,PF-573228,0.37 uM,24 h,3,65,68,1,2,2,0,NEU
TAK-715_0.37uM_24h,TAK-715,0.37 uM,24 h,3,65,68,1,1,1,0,NEU
GNF-2_0.37uM_24h,GNF-2,0.37 uM,24 h,3,65,68,1,1,0,1,NEU
HMN-214_0.37uM_24h,HMN-214,0.37 uM,24 h,3,65,68,1,8,6,2,NEU
VX-745_0.37uM_24h,VX-745,0.37 uM,24 h,3,65,68,1,0,0,0,NEU
NVP-BHG712_0.37uM_24h,NVP-BHG712,0.37 uM,24 h,3,65,68,1,3,1,2,NEU
BX-795_0.37uM_24h,BX-795,0.37 uM,24 h,3,65,68,1,0,0,0,NEU
GW-5074_0.37uM_24h,GW-5074,0.37 uM,24 h,3,65,68,1,2,2,0,NEU
D-4476_0.37uM_24h,D-4476,0.37 uM,24 h,3,65,68,1,0,0,0,NEU
BAY-61-3606_0.37uM_24h,BAY-61-3606,0.37 uM,24 h,3,65,68,1,2,2,0,NEU
PF-03758309_0.37uM_24h,PF-03758309,0.37 uM,24 h,3,65,68,1,14,0,14,NEU
ZM-447439_0.37uM_24h,ZM-447439,0.37 uM,24 h,3,65,68,1,3,3,0,NEU
JNJ-38877605_0.37uM_24h,JNJ-38877605,0.37 uM,24 h,3,65,68,1,1,1,0,NEU
regorafenib_0.37uM_24h,regorafenib,0.37 uM,24 h,3,65,68,1,0,0,0,NEU
serdemetan_0.37uM_24h,serdemetan,0.37 uM,24 h,3,65,68,1,0,0,0,NEU
MGCD-265_1.11uM_24h,MGCD-265,1.11 uM,24 h,3,65,68,1,2,2,0,NEU
SB-239063_1.11uM_24h,SB-239063,1.11 uM,24 h,3,65,68,1,0,0,0,NEU
TAK-715_1.11uM_24h,TAK-715,1.11 uM,24 h,3,65,68,1,0,0,0,NEU
serdemetan_1.11uM_24h,serdemetan,1.11 uM,24 h,3,65,68,1,1,1,0,NEU
KI-20227_1.11uM_24h,KI-20227,1.11 uM,24 h,3,65,68,1,3,2,1,NEU
VX-745_1.11uM_24h,VX-745,1.11 uM,24 h,3,65,68,1,1,0,1,NEU
PF-03758309_1.11uM_24h,PF-03758309,1.11 uM,24 h,3,65,68,1,25,6,19,NEU
BI-2536_1.11uM_24h,BI-2536,1.11 uM,24 h,3,65,68,1,0,0,0,NEU
GNF-2_1.11uM_24h,GNF-2,1.11 uM,24 h,3,65,68,1,1,1,0,NEU
regorafenib_1.11uM_24h,regorafenib,1.11 uM,24 h,3,65,68,1,0,0,0,NEU
GW-5074_1.11uM_24h,GW-5074,1.11 uM,24 h,3,65,68,1,4,1,3,NEU
JNJ-38877605_1.11uM_24h,JNJ-38877605,1.11 uM,24 h,3,65,68,1,0,0,0,NEU
PF-573228_1.11uM_24h,PF-573228,1.11 uM,24 h,3,65,68,1,3,1,2,NEU
D-4476_1.11uM_24h,D-4476,1.11 uM,24 h,3,65,68,1,5,4,1,NEU
alectinib_1.11uM_24h,alectinib,1.11 uM,24 h,3,65,68,1,1,1,0,NEU
BAY-61-3606_1.11uM_24h,BAY-61-3606,1.11 uM,24 h,3,65,68,1,6,5,1,NEU
dabrafenib_1.11uM_24h,dabrafenib,1.11 uM,24 h,3,65,68,1,12,11,1,NEU
A-769662_1.11uM_24h,A-769662,1.11 uM,24 h,3,65,68,1,0,0,0,NEU
ZM-447439_1.11uM_24h,ZM-447439,1.11 uM,24 h,3,65,68,1,1,1,0,NEU
rigosertib_1.11uM_24h,rigosertib,1.11 uM,24 h,3,65,68,1,4,4,0,NEU
CC-401_1.11uM_24h,CC-401,1.11 uM,24 h,3,65,68,1,0,0,0,NEU
HMN-214_1.11uM_24h,HMN-214,1.11 uM,24 h,3,65,68,1,4,4,0,NEU
SB-203580_1.11uM_24h,SB-203580,1.11 uM,24 h,3,65,68,1,0,0,0,NEU
NVP-BHG712_1.11uM_24h,NVP-BHG712,1.11 uM,24 h,3,65,68,1,0,0,0,NEU
GDC-0879_1.11uM_24h,GDC-0879,1.11 uM,24 h,3,65,68,1,2,2,0,NEU
BX-795_1.11uM_24h,BX-795,1.11 uM,24 h,3,65,68,1,2,1,1,NEU
pyrazolanthrone_1.11uM_24h,pyrazolanthrone,1.11 uM,24 h,3,65,68,1,3,3,0,NEU
SB-203580_3.33uM_24h,SB-203580,3.33 uM,24 h,3,65,68,1,0,0,0,NEU
SB-239063_3.33uM_24h,SB-239063,3.33 uM,24 h,3,65,68,1,2,1,1,NEU
GDC-0879_3.33uM_24h,GDC-0879,3.33 uM,24 h,3,65,68,1,3,2,1,NEU
KI-20227_3.33uM_24h,KI-20227,3.33 uM,24 h,3,65,68,1,1,1,0,NEU
serdemetan_3.33uM_24h,serdemetan,3.33 uM,24 h,3,65,68,1,1,0,1,NEU
alectinib_3.33uM_24h,alectinib,3.33 uM,24 h,3,65,68,1,0,0,0,NEU
CC-401_3.33uM_24h,CC-401,3.33 uM,24 h,3,65,68,1,0,0,0,NEU
PF-03758309_3.33uM_24h,PF-03758309,3.33 uM,24 h,3,65,68,1,30,10,20,NEU
MGCD-265_3.33uM_24h,MGCD-265,3.33 uM,24 h,3,65,68,1,1,1,0,NEU
ZM-447439_3.33uM_24h,ZM-447439,3.33 uM,24 h,3,65,68,1,4,3,1,NEU
ponatinib_3.33uM_24h,ponatinib,3.33 uM,24 h,3,65,68,1,3,3,0,NEU
dabrafenib_3.33uM_24h,dabrafenib,3.33 uM,24 h,3,65,68,1,6,6,0,NEU
regorafenib_3.33uM_24h,regorafenib,3.33 uM,24 h,3,65,68,1,4,2,2,NEU
D-4476_3.33uM_24h,D-4476,3.33 uM,24 h,3,65,68,1,1,0,1,NEU
NVP-BHG712_3.33uM_24h,NVP-BHG712,3.33 uM,24 h,3,65,68,1,2,2,0,NEU
PF-573228_3.33uM_24h,PF-573228,3.33 uM,24 h,3,65,68,1,2,2,0,NEU
rigosertib_3.33uM_24h,rigosertib,3.33 uM,24 h,3,65,68,1,7,5,2,NEU
GNF-2_3.33uM_24h,GNF-2,3.33 uM,24 h,3,65,68,1,4,2,2,NEU
pyrazolanthrone_3.33uM_24h,pyrazolanthrone,3.33 uM,24 h,3,65,68,1,0,0,0,NEU
BI-2536_3.33uM_24h,BI-2536,3.33 uM,24 h,3,65,68,1,1,1,0,NEU
VX-745_3.33uM_24h,VX-745,3.33 uM,24 h,3,65,68,1,5,3,2,NEU
A-769662_3.33uM_24h,A-769662,3.33 uM,24 h,3,65,68,1,0,0,0,NEU
HMN-214_3.33uM_24h,HMN-214,3.33 uM,24 h,3,65,68,1,4,4,0,NEU
BX-795_3.33uM_24h,BX-795,3.33 uM,24 h,3,65,68,1,0,0,0,NEU
BAY-61-3606_3.33uM_24h,BAY-61-3606,3.33 uM,24 h,3,65,68,1,8,8,0,NEU
GW-5074_3.33uM_24h,GW-5074,3.33 uM,24 h,3,65,68,1,1,1,0,NEU
JNJ-38877605_3.33uM_24h,JNJ-38877605,3.33 uM,24 h,3,65,68,1,2,1,1,NEU
kcl_0.12uM_6h,kcl,0.12 uM,6 h,71,76,147,2,23,20,3,NEU
kcl_0.12uM_24h,kcl,0.12 uM,24 h,70,49,119,2,485,187,298,NEU
nacl_0.12uM_6h,nacl,0.12 uM,6 h,68,76,144,2,23,17,6,NEU
nacl_0.12uM_24h,nacl,0.12 uM,24 h,63,49,112,2,462,167,295,NEU
BRD-A19037878_10uM_24h,BRD-A19037878,10 uM,24 h,20,206,226,8,514,267,247,NEU
BRD-K68202742_10uM_24h,BRD-K68202742,10 uM,24 h,11,72,83,3,406,210,196,NEU
LY-456236_10uM_24h,LY-456236,10 uM,24 h,9,81,90,3,1,0,1,NEU
GSK-1059615_10uM_24h,GSK-1059615,10 uM,24 h,9,142,151,3,26,8,18,NEU
GSK-1059615_0.04uM_24h,GSK-1059615,0.04 uM,24 h,9,142,151,3,1,1,0,NEU
GSK-1059615_0.12uM_24h,GSK-1059615,0.12 uM,24 h,9,142,151,3,0,0,0,NEU
GSK-1059615_0.37uM_24h,GSK-1059615,0.37 uM,24 h,9,142,151,3,5,1,4,NEU
GSK-1059615_1.11uM_24h,GSK-1059615,1.11 uM,24 h,9,142,151,3,17,3,14,NEU
BRD-K41170226_10uM_24h,BRD-K41170226,10 uM,24 h,8,44,52,2,0,0,0,NEU
BRD-K05396879_10uM_24h,BRD-K05396879,10 uM,24 h,8,76,84,3,10,5,5,NEU
alitretinoin_10uM_24h,alitretinoin,10 uM,24 h,8,76,84,3,2,1,1,NEU
BRD-K55591206_10uM_24h,BRD-K55591206,10 uM,24 h,8,112,120,3,0,0,0,NEU
apicidin_10uM_24h,apicidin,10 uM,24 h,8,40,48,2,396,193,203,NEU
AGK-2_10uM_24h,AGK-2,10 uM,24 h,8,105,113,3,55,20,35,NEU
GSK-1059615_3.33uM_24h,GSK-1059615,3.33 uM,24 h,8,121,129,2,25,3,22,NEU
GSK-429286A_10uM_24h,GSK-429286A,10 uM,24 h,7,81,88,2,3,1,2,NEU
LY-294002_10uM_24h,LY-294002,10 uM,24 h,7,81,88,3,20,2,18,NEU
BRD-K41170226_10uM_6h,BRD-K41170226,10 uM,6 h,6,29,35,1,0,0,0,NEU
latrunculin-b_10uM_24h,latrunculin-b,10 uM,24 h,6,32,38,1,0,0,0,NEU
BRD-K68202742_10uM_6h,BRD-K68202742,10 uM,6 h,6,29,35,1,241,142,99,NEU
enevalproate_10uM_6h,enevalproate,10 uM,6 h,6,47,53,1,0,0,0,NEU
brefeldin-a_10uM_24h,brefeldin-a,10 uM,24 h,6,56,62,2,303,163,140,NEU
BRD-K78075916_10uM_6h,BRD-K78075916,10 uM,6 h,6,47,53,1,8,4,4,NEU
EHNA_10uM_24h,EHNA,10 uM,24 h,6,56,62,2,0,0,0,NEU
thenoyltrifluoroacetone_10uM_24h,thenoyltrifluoroacetone,10 uM,24 h,6,56,62,2,0,0,0,NEU
AGK-2_10uM_6h,AGK-2,10 uM,6 h,6,76,82,2,0,0,0,NEU
BRD-A19037878_10uM_6h,BRD-A19037878,10 uM,6 h,6,76,82,2,225,123,102,NEU
MK-801_10uM_6h,MK-801,10 uM,6 h,6,47,53,1,0,0,0,NEU
BRD-K78075916_10uM_24h,BRD-K78075916,10 uM,24 h,6,25,31,1,9,5,4,NEU
LY-456236_10uM_6h,LY-456236,10 uM,6 h,6,76,82,2,1,1,0,NEU
tunicamycin_10uM_24h,tunicamycin,10 uM,24 h,6,56,62,2,116,54,62,NEU
BL-077_10uM_24h,BL-077,10 uM,24 h,5,44,49,2,1,1,0,NEU
BRD-K82206012_10uM_24h,BRD-K82206012,10 uM,24 h,5,44,49,2,0,0,0,NEU
garcinol_10uM_24h,garcinol,10 uM,24 h,5,80,85,2,1,0,1,NEU
BRD-K18135438_10uM_24h,BRD-K18135438,10 uM,24 h,5,44,49,2,0,0,0,NEU
ALW-II-38-3_10uM_24h,ALW-II-38-3,10 uM,24 h,5,81,86,2,2,2,0,NEU
rifampicin_10uM_24h,rifampicin,10 uM,24 h,5,44,49,2,2,0,2,NEU
MLN-8054_10uM_24h,MLN-8054,10 uM,24 h,5,85,90,2,1,0,1,NEU
BRD-K59946561_10uM_24h,BRD-K59946561,10 uM,24 h,5,44,49,2,11,2,9,NEU
BRD-K20986251_10uM_24h,BRD-K20986251,10 uM,24 h,5,44,49,2,0,0,0,NEU
taurodeoxycholic-acid_10uM_24h,taurodeoxycholic-acid,10 uM,24 h,5,44,49,2,13,5,8,NEU
H-9_10uM_24h,H-9,10 uM,24 h,5,52,57,2,0,0,0,NEU
BRD-K62459624_10uM_24h,BRD-K62459624,10 uM,24 h,5,52,57,2,11,9,2,NEU
taurocholic-acid_10uM_24h,taurocholic-acid,10 uM,24 h,5,44,49,2,2,2,0,NEU
BRD-K61463582_10uM_24h,BRD-K61463582,10 uM,24 h,5,44,49,2,2,1,1,NEU
TCPOBOP_10uM_24h,TCPOBOP,10 uM,24 h,5,44,49,2,0,0,0,NEU
XMD-892_10uM_24h,XMD-892,10 uM,24 h,5,85,90,2,4,2,2,NEU
QL-XI-92_10uM_24h,QL-XI-92,10 uM,24 h,5,85,90,2,6,4,2,NEU
BRD-K04923131_10uM_24h,BRD-K04923131,10 uM,24 h,5,44,49,2,98,46,52,NEU
BRD-K37846922_10uM_24h,BRD-K37846922,10 uM,24 h,5,44,49,2,1,0,1,NEU
antimycin-a_10uM_24h,antimycin-a,10 uM,24 h,5,52,57,2,1,1,0,NEU
enevalproate_10uM_24h,enevalproate,10 uM,24 h,5,25,30,1,2,0,2,NEU
BRD-A96799240_10uM_24h,BRD-A96799240,10 uM,24 h,5,44,49,2,13,2,11,NEU
epoxycholesterol_10uM_24h,epoxycholesterol,10 uM,24 h,5,44,49,2,6,0,6,NEU
KIN-001-220_10uM_24h,KIN-001-220,10 uM,24 h,5,85,90,2,11,8,3,NEU
BRD-K79437791_10uM_24h,BRD-K79437791,10 uM,24 h,5,44,49,2,0,0,0,NEU
EMF-sumo1-10_10uM_24h,EMF-sumo1-10,10 uM,24 h,5,52,57,2,0,0,0,NEU
KIN001-055_10uM_24h,KIN001-055,10 uM,24 h,5,85,90,2,5,2,3,NEU
KIN001-127_10uM_24h,KIN001-127,10 uM,24 h,5,85,90,2,0,0,0,NEU
BRD-K95760042_10uM_24h,BRD-K95760042,10 uM,24 h,5,48,53,2,4,3,1,NEU
geranylgeraniol_10uM_24h,geranylgeraniol,10 uM,24 h,5,44,49,2,1,1,0,NEU
GR-206_10uM_24h,GR-206,10 uM,24 h,5,44,49,2,31,7,24,NEU
anacardic-acid_10uM_24h,anacardic-acid,10 uM,24 h,5,80,85,2,0,0,0,NEU
BRD-K65411918_10uM_24h,BRD-K65411918,10 uM,24 h,5,44,49,2,0,0,0,NEU
MK-801_10uM_24h,MK-801,10 uM,24 h,5,25,30,1,1,1,0,NEU
desmethylclomipramine_10uM_6h,desmethylclomipramine,10 uM,6 h,5,66,71,2,4,3,1,NEU
androstanol_10uM_24h,androstanol,10 uM,24 h,5,44,49,2,2,1,1,NEU
BL-050_10uM_24h,BL-050,10 uM,24 h,5,44,49,2,0,0,0,NEU
BRD-K68144790_10uM_24h,BRD-K68144790,10 uM,24 h,5,44,49,2,2,1,1,NEU
androstenedione_10uM_24h,androstenedione,10 uM,24 h,5,44,49,2,1,1,0,NEU
CG-930_10uM_24h,CG-930,10 uM,24 h,5,85,90,2,0,0,0,NEU
BRD-K64024097_10uM_24h,BRD-K64024097,10 uM,24 h,5,40,45,2,0,0,0,NEU
KIN001-242_10uM_24h,KIN001-242,10 uM,24 h,5,85,90,2,0,0,0,NEU
eicosatetraynoic-acid_10uM_24h,eicosatetraynoic-acid,10 uM,24 h,5,44,49,2,7,6,1,NEU
retinyl_10uM_24h,retinyl,10 uM,24 h,5,44,49,2,0,0,0,NEU
desmethylclomipramine_10uM_24h,desmethylclomipramine,10 uM,24 h,5,40,45,2,524,168,356,NEU
BRD-K38756014_10uM_24h,BRD-K38756014,10 uM,24 h,5,44,49,2,0,0,0,NEU
AZD-7762_10uM_24h,AZD-7762,10 uM,24 h,5,81,86,2,4,3,1,NEU
androstenol_10uM_24h,androstenol,10 uM,24 h,4,32,36,2,30,9,21,NEU
GSK-1070916_10uM_24h,GSK-1070916,10 uM,24 h,4,76,80,2,72,17,55,NEU
BRD-A26595446_10uM_24h,BRD-A26595446,10 uM,24 h,4,20,24,1,0,0,0,NEU
BRD-K67808578_10uM_24h,BRD-K67808578,10 uM,24 h,4,36,40,2,0,0,0,NEU
EMF-sumo1-8_10uM_24h,EMF-sumo1-8,10 uM,24 h,4,20,24,1,2,0,2,NEU
terreic-acid_10uM_24h,terreic-acid,10 uM,24 h,4,32,36,2,166,41,125,NEU
EMF-sumo1-3_10uM_24h,EMF-sumo1-3,10 uM,24 h,4,20,24,1,0,0,0,NEU
F-1566-0341_10uM_24h,F-1566-0341,10 uM,24 h,4,36,40,2,2,1,1,NEU
BRD-K63350243_10uM_24h,BRD-K63350243,10 uM,24 h,4,36,40,2,1,1,0,NEU
BRD-A57107094_10uM_24h,BRD-A57107094,10 uM,24 h,4,36,40,2,2,1,1,NEU
GSK-461364_10uM_24h,GSK-461364,10 uM,24 h,4,72,76,2,21,12,9,NEU
RAN-07_10uM_24h,RAN-07,10 uM,24 h,4,44,48,2,0,0,0,NEU
guggulsterone_10uM_24h,guggulsterone,10 uM,24 h,4,44,48,2,4,3,1,NEU
EMF-sumo1-5_10uM_24h,EMF-sumo1-5,10 uM,24 h,4,20,24,1,0,0,0,NEU
farnesol_10uM_24h,farnesol,10 uM,24 h,4,32,36,2,0,0,0,NEU
EMF-sumo1-4_10uM_24h,EMF-sumo1-4,10 uM,24 h,4,20,24,1,0,0,0,NEU
EMF-sumo1-2_10uM_24h,EMF-sumo1-2,10 uM,24 h,4,20,24,1,0,0,0,NEU
AZD-6482_10uM_24h,AZD-6482,10 uM,24 h,4,20,24,1,0,0,0,NEU
BRD-K75181824_10uM_24h,BRD-K75181824,10 uM,24 h,4,32,36,2,1,0,1,NEU
JWE-035_10uM_24h,JWE-035,10 uM,24 h,4,73,77,2,0,0,0,NEU
NPK76-II-72-1_10uM_24h,NPK76-II-72-1,10 uM,24 h,4,76,80,2,3,1,2,NEU
EMF-sumo1-1_10uM_24h,EMF-sumo1-1,10 uM,24 h,4,20,24,1,0,0,0,NEU
BRD-A19037878_0.37uM_24h,BRD-A19037878,0.37 uM,24 h,4,57,61,2,190,96,94,NEU
LY-294002_0.37uM_24h,LY-294002,0.37 uM,24 h,4,57,61,2,6,4,2,NEU
LY-294002_1.11uM_24h,LY-294002,1.11 uM,24 h,4,57,61,2,9,5,4,NEU
BRD-A19037878_1.11uM_24h,BRD-A19037878,1.11 uM,24 h,4,57,61,2,394,192,202,NEU
BRD-A19037878_3.33uM_24h,BRD-A19037878,3.33 uM,24 h,4,57,61,2,401,202,199,NEU
SR-142948_10uM_6h,SR-142948,10 uM,6 h,3,47,50,1,0,0,0,NEU
BRD-A68802837_10uM_6h,BRD-A68802837,10 uM,6 h,3,47,50,1,3,2,1,NEU
BRD-K67582595_10uM_24h,BRD-K67582595,10 uM,24 h,3,25,28,1,189,68,121,NEU
BRD-K81647657_10uM_6h,BRD-K81647657,10 uM,6 h,3,29,32,1,0,0,0,NEU
rotenone_10uM_24h,rotenone,10 uM,24 h,3,24,27,1,361,165,196,NEU
BG-1020_10uM_24h,BG-1020,10 uM,24 h,3,24,27,1,0,0,0,NEU
BRD-K18074178_10uM_24h,BRD-K18074178,10 uM,24 h,3,32,35,1,5,2,3,NEU
BRD-K10010115_10uM_24h,BRD-K10010115,10 uM,24 h,3,32,35,1,5,4,1,NEU
PLX-4720_10uM_24h,PLX-4720,10 uM,24 h,3,28,31,2,0,0,0,NEU
BRD-K38720323_10uM_6h,BRD-K38720323,10 uM,6 h,3,47,50,1,2,2,0,NEU
BRD-U71399930_10uM_6h,BRD-U71399930,10 uM,6 h,3,47,50,1,2,2,0,NEU
androstenol_10uM_6h,androstenol,10 uM,6 h,3,29,32,1,2,2,0,NEU
BRD-K65213718_10uM_6h,BRD-K65213718,10 uM,6 h,3,47,50,1,5,4,1,NEU
BRD-K00878439_10uM_6h,BRD-K00878439,10 uM,6 h,3,47,50,1,0,0,0,NEU
BRD-K12482929_10uM_6h,BRD-K12482929,10 uM,6 h,3,47,50,1,1,0,1,NEU
BRD-K74773935_10uM_24h,BRD-K74773935,10 uM,24 h,3,25,28,1,1,1,0,NEU
BRD-K32307229_10uM_6h,BRD-K32307229,10 uM,6 h,3,29,32,1,96,52,44,NEU
BRD-K43631199_10uM_24h,BRD-K43631199,10 uM,24 h,3,25,28,1,6,2,4,NEU
BRD-A36066264_10uM_24h,BRD-A36066264,10 uM,24 h,3,32,35,1,0,0,0,NEU
BRD-K16309743_10uM_24h,BRD-K16309743,10 uM,24 h,3,32,35,1,2,1,1,NEU
cardamonin_10uM_24h,cardamonin,10 uM,24 h,3,24,27,1,2,1,1,NEU
BG-1019_10uM_6h,BG-1019,10 uM,6 h,3,29,32,1,0,0,0,NEU
salermide_10uM_24h,salermide,10 uM,24 h,3,24,27,1,61,19,42,NEU
HDAC3-selective_10uM_24h,HDAC3-selective,10 uM,24 h,3,25,28,1,28,11,17,NEU
androstanol_10uM_6h,androstanol,10 uM,6 h,3,29,32,1,0,0,0,NEU
BRD-U71399930_10uM_24h,BRD-U71399930,10 uM,24 h,3,25,28,1,8,5,3,NEU
MW-STK33-3B_10uM_24h,MW-STK33-3B,10 uM,24 h,3,32,35,1,8,2,6,NEU
skimmianine_10uM_24h,skimmianine,10 uM,24 h,3,32,35,1,1,0,1,NEU
BRD-A73847809_10uM_24h,BRD-A73847809,10 uM,24 h,3,32,35,1,1,0,1,NEU
BRD-K16290432_10uM_24h,BRD-K16290432,10 uM,24 h,3,32,35,1,6,5,1,NEU
BRD-K86269644_10uM_24h,BRD-K86269644,10 uM,24 h,3,32,35,1,0,0,0,NEU
hinokitiol_10uM_24h,hinokitiol,10 uM,24 h,3,32,35,1,1,1,0,NEU
BRD-K63245238_10uM_24h,BRD-K63245238,10 uM,24 h,3,32,35,1,11,8,3,NEU
BRD-K64985742_10uM_24h,BRD-K64985742,10 uM,24 h,3,32,35,1,0,0,0,NEU
BRD-K09977233_10uM_24h,BRD-K09977233,10 uM,24 h,3,32,35,1,0,0,0,NEU
BRD-K72429558_10uM_24h,BRD-K72429558,10 uM,24 h,3,32,35,1,0,0,0,NEU
BRD-A42610307_10uM_24h,BRD-A42610307,10 uM,24 h,3,25,28,1,105,42,63,NEU
BRD-A42187224_10uM_6h,BRD-A42187224,10 uM,6 h,3,47,50,1,1,1,0,NEU
BRD-K10939925_10uM_6h,BRD-K10939925,10 uM,6 h,3,47,50,1,8,6,2,NEU
BG-1030_10uM_6h,BG-1030,10 uM,6 h,3,29,32,1,148,86,62,NEU
BG-1029_10uM_24h,BG-1029,10 uM,24 h,3,24,27,1,382,175,207,NEU
IDAM_10uM_24h,IDAM,10 uM,24 h,3,25,28,1,24,4,20,NEU
BRD-A04332542_10uM_6h,BRD-A04332542,10 uM,6 h,3,47,50,1,0,0,0,NEU
QW-BI-011_10uM_24h,QW-BI-011,10 uM,24 h,3,32,35,1,13,8,5,NEU
BRD-K00816165_10uM_24h,BRD-K00816165,10 uM,24 h,3,32,35,1,142,68,74,NEU
BRD-K58279162_10uM_24h,BRD-K58279162,10 uM,24 h,3,32,35,1,16,13,3,NEU
I-212148_10uM_24h,I-212148,10 uM,24 h,3,32,35,1,0,0,0,NEU
BRD-K76941385_10uM_6h,BRD-K76941385,10 uM,6 h,3,47,50,1,1,1,0,NEU
BRD-K80062189_10uM_24h,BRD-K80062189,10 uM,24 h,3,25,28,1,2,2,0,NEU
BRD-K83068825_10uM_6h,BRD-K83068825,10 uM,6 h,3,47,50,1,1,1,0,NEU
dihydrocapsaicin_10uM_24h,dihydrocapsaicin,10 uM,24 h,3,24,27,1,5,1,4,NEU
BRD-A08027849_10uM_24h,BRD-A08027849,10 uM,24 h,3,24,27,1,73,20,53,NEU
BRD-K54472228_10uM_24h,BRD-K54472228,10 uM,24 h,3,25,28,1,1,0,1,NEU
BRD-K40167599_10uM_24h,BRD-K40167599,10 uM,24 h,3,25,28,1,2,1,1,NEU
BRD-K55996963_10uM_24h,BRD-K55996963,10 uM,24 h,3,32,35,1,0,0,0,NEU
ST-024029_10uM_24h,ST-024029,10 uM,24 h,3,32,35,1,2,1,1,NEU
BRD-K54906270_10uM_24h,BRD-K54906270,10 uM,24 h,3,32,35,1,2,1,1,NEU
LM-1685_10uM_24h,LM-1685,10 uM,24 h,3,32,35,1,15,9,6,NEU
BRD-K78844995_10uM_24h,BRD-K78844995,10 uM,24 h,3,32,35,1,0,0,0,NEU
epoxycholesterol_10uM_6h,epoxycholesterol,10 uM,6 h,3,29,32,1,5,0,5,NEU
BRD-K41049123_10uM_24h,BRD-K41049123,10 uM,24 h,3,25,28,1,9,5,4,NEU
methoxypyruvic-acid_10uM_6h,methoxypyruvic-acid,10 uM,6 h,3,47,50,1,0,0,0,NEU
BRD-K39981244_10uM_6h,BRD-K39981244,10 uM,6 h,3,47,50,1,3,2,1,NEU
BRD-A42994615_10uM_6h,BRD-A42994615,10 uM,6 h,3,29,32,1,0,0,0,NEU
retinyl_10uM_6h,retinyl,10 uM,6 h,3,29,32,1,1,1,0,NEU
PNU-96415E_10uM_24h,PNU-96415E,10 uM,24 h,3,32,35,1,4,2,2,NEU
BRD-K08630646_10uM_24h,BRD-K08630646,10 uM,24 h,3,32,35,1,0,0,0,NEU
emodic-acid_10uM_24h,emodic-acid,10 uM,24 h,3,32,35,1,0,0,0,NEU
propylpyrazole_10uM_24h,propylpyrazole,10 uM,24 h,3,32,35,1,0,0,0,NEU
huperzine-a_10uM_24h,huperzine-a,10 uM,24 h,3,32,35,1,11,10,1,NEU
ST-4062971_10uM_24h,ST-4062971,10 uM,24 h,3,20,23,1,0,0,0,NEU
BRD-K30194621_10uM_24h,BRD-K30194621,10 uM,24 h,3,32,35,1,124,29,95,NEU
BRD-K32485462_10uM_24h,BRD-K32485462,10 uM,24 h,3,32,35,1,0,0,0,NEU
bafilomycin_10uM_6h,bafilomycin,10 uM,6 h,3,29,32,1,1,1,0,NEU
BRD-K64729807_10uM_6h,BRD-K64729807,10 uM,6 h,3,29,32,1,0,0,0,NEU
BRD-K33943862_10uM_6h,BRD-K33943862,10 uM,6 h,3,47,50,1,7,3,4,NEU
BRD-K20151898_10uM_24h,BRD-K20151898,10 uM,24 h,3,25,28,1,4,1,3,NEU
BRD-A27924917_10uM_6h,BRD-A27924917,10 uM,6 h,3,47,50,1,2,2,0,NEU
1-methylisoquinoline_10uM_24h,1-methylisoquinoline,10 uM,24 h,3,25,28,1,13,2,11,NEU
W-7_10uM_6h,W-7,10 uM,6 h,3,47,50,1,0,0,0,NEU
timosaponin_10uM_6h,timosaponin,10 uM,6 h,3,29,32,1,183,38,145,NEU
6-nitronorepinephrine_10uM_24h,6-nitronorepinephrine,10 uM,24 h,3,25,28,1,0,0,0,NEU
HO-013_10uM_6h,HO-013,10 uM,6 h,3,29,32,1,0,0,0,NEU
SKF-82958_10uM_6h,SKF-82958,10 uM,6 h,3,47,50,1,4,2,2,NEU
carnosol_10uM_24h,carnosol,10 uM,24 h,3,24,27,1,178,45,133,NEU
rottlerin_10uM_6h,rottlerin,10 uM,6 h,3,29,32,1,17,11,6,NEU
IM-12_10uM_24h,IM-12,10 uM,24 h,3,24,27,1,3,2,1,NEU
BRD-A96799240_10uM_6h,BRD-A96799240,10 uM,6 h,3,29,32,1,0,0,0,NEU
BRD-K63792901_10uM_24h,BRD-K63792901,10 uM,24 h,3,32,35,1,0,0,0,NEU
BRD-K29715937_10uM_24h,BRD-K29715937,10 uM,24 h,3,32,35,1,0,0,0,NEU
JS-K_10uM_6h,JS-K,10 uM,6 h,3,29,32,1,27,10,17,NEU
BRD-K23875128_10uM_6h,BRD-K23875128,10 uM,6 h,3,29,32,1,0,0,0,NEU
BRD-K72015216_10uM_24h,BRD-K72015216,10 uM,24 h,3,25,28,1,0,0,0,NEU
p-aminophenethylspiperone_10uM_24h,p-aminophenethylspiperone,10 uM,24 h,3,25,28,1,51,21,30,NEU
BRD-K92159000_10uM_24h,BRD-K92159000,10 uM,24 h,3,25,28,1,3,2,1,NEU
BG-1010_10uM_6h,BG-1010,10 uM,6 h,3,29,32,1,26,12,14,NEU
BRD-K15241725_10uM_6h,BRD-K15241725,10 uM,6 h,3,47,50,1,0,0,0,NEU
XMD-885_10uM_24h,XMD-885,10 uM,24 h,3,41,44,2,11,7,4,NEU
velnacrine_10uM_24h,velnacrine,10 uM,24 h,3,25,28,1,0,0,0,NEU
dithiothreitol_10uM_6h,dithiothreitol,10 uM,6 h,3,29,32,1,0,0,0,NEU
tyramine_10uM_24h,tyramine,10 uM,24 h,3,25,28,1,0,0,0,NEU
BRD-M68558198_10uM_6h,BRD-M68558198,10 uM,6 h,3,47,50,1,4,2,2,NEU
BG-1025_10uM_6h,BG-1025,10 uM,6 h,3,29,32,1,142,76,66,NEU
HDAC1-selective_10uM_24h,HDAC1-selective,10 uM,24 h,3,24,27,1,246,93,153,NEU
BRD-K09887211_10uM_6h,BRD-K09887211,10 uM,6 h,3,47,50,1,4,3,1,NEU
BRD-K83872150_10uM_6h,BRD-K83872150,10 uM,6 h,3,29,32,1,0,0,0,NEU
BRD-K01614657_10uM_24h,BRD-K01614657,10 uM,24 h,3,32,35,1,61,31,30,NEU
BRD-K47709646_10uM_24h,BRD-K47709646,10 uM,24 h,3,32,35,1,0,0,0,NEU
SKF-104078_10uM_6h,SKF-104078,10 uM,6 h,3,47,50,1,0,0,0,NEU
BRD-A29342309_10uM_6h,BRD-A29342309,10 uM,6 h,3,47,50,1,0,0,0,NEU
DASB_10uM_24h,DASB,10 uM,24 h,3,25,28,1,0,0,0,NEU
BRD-K30553817_10uM_24h,BRD-K30553817,10 uM,24 h,3,25,28,1,119,49,70,NEU
BRD-K18722736_10uM_24h,BRD-K18722736,10 uM,24 h,3,25,28,1,255,72,183,NEU
salsoline_10uM_24h,salsoline,10 uM,24 h,3,25,28,1,2,0,2,NEU
BRD-K04722205_10uM_6h,BRD-K04722205,10 uM,6 h,3,29,32,1,0,0,0,NEU
BRD-M29370314_10uM_6h,BRD-M29370314,10 uM,6 h,3,47,50,1,2,1,1,NEU
BRD-K75458636_10uM_24h,BRD-K75458636,10 uM,24 h,3,32,35,1,5,3,2,NEU
BRD-A26962727_10uM_24h,BRD-A26962727,10 uM,24 h,3,32,35,1,1,1,0,NEU
BRD-K07023879_10uM_24h,BRD-K07023879,10 uM,24 h,3,32,35,1,4,1,3,NEU
BG-1004_10uM_24h,BG-1004,10 uM,24 h,3,25,28,1,210,67,143,NEU
farnesylthioacetic-acid_10uM_6h,farnesylthioacetic-acid,10 uM,6 h,3,29,32,1,0,0,0,NEU
BRD-K68144790_10uM_6h,BRD-K68144790,10 uM,6 h,3,29,32,1,0,0,0,NEU
lactotensin_10uM_24h,lactotensin,10 uM,24 h,3,25,28,1,0,0,0,NEU
thapsigargin_10uM_6h,thapsigargin,10 uM,6 h,3,29,32,1,73,53,20,NEU
BRD-A76934284_10uM_24h,BRD-A76934284,10 uM,24 h,3,25,28,1,63,17,46,NEU
BRD-K48924007_10uM_24h,BRD-K48924007,10 uM,24 h,3,32,35,1,7,1,6,NEU
BRD-K62748479_10uM_24h,BRD-K62748479,10 uM,24 h,3,32,35,1,12,9,3,NEU
SPB02303_10uM_24h,SPB02303,10 uM,24 h,3,32,35,1,2,1,1,NEU
STK-661558_10uM_24h,STK-661558,10 uM,24 h,3,32,35,1,2,0,2,NEU
BRD-K70891562_10uM_24h,BRD-K70891562,10 uM,24 h,3,32,35,1,4,3,1,NEU
BRD-K82971429_10uM_24h,BRD-K82971429,10 uM,24 h,3,32,35,1,6,6,0,NEU
BRD-K69496360_10uM_24h,BRD-K69496360,10 uM,24 h,3,32,35,1,12,2,10,NEU
ARG-CSC2-23_10uM_24h,ARG-CSC2-23,10 uM,24 h,3,32,35,1,0,0,0,NEU
methoprene-acid_10uM_24h,methoprene-acid,10 uM,24 h,3,24,27,1,75,22,53,NEU
SR-12813_10uM_6h,SR-12813,10 uM,6 h,3,47,50,1,4,3,1,NEU
BRD-K56994829_10uM_6h,BRD-K56994829,10 uM,6 h,3,47,50,1,1,0,1,NEU
BRD-K19042873_10uM_6h,BRD-K19042873,10 uM,6 h,3,47,50,1,6,4,2,NEU
BRD-A42187224_10uM_24h,BRD-A42187224,10 uM,24 h,3,25,28,1,200,67,133,NEU
BRD-K83836748_10uM_6h,BRD-K83836748,10 uM,6 h,3,47,50,1,2,1,1,NEU
WAY-262611_10uM_24h,WAY-262611,10 uM,24 h,3,24,27,1,505,185,320,NEU
BRD-K31168993_10uM_24h,BRD-K31168993,10 uM,24 h,3,25,28,1,0,0,0,NEU
BRD-K56622826_10uM_6h,BRD-K56622826,10 uM,6 h,3,47,50,1,1,0,1,NEU
BRD-K42823101_10uM_24h,BRD-K42823101,10 uM,24 h,3,25,28,1,8,2,6,NEU
BRD-K32896438_10uM_24h,BRD-K32896438,10 uM,24 h,3,32,35,1,64,39,25,NEU
cephaeline_10uM_24h,cephaeline,10 uM,24 h,3,32,35,1,134,75,59,NEU
BRD-A16581344_10uM_24h,BRD-A16581344,10 uM,24 h,3,32,35,1,12,8,4,NEU
BRD-K52099002_10uM_24h,BRD-K52099002,10 uM,24 h,3,32,35,1,1,0,1,NEU
BRD-K16604360_10uM_24h,BRD-K16604360,10 uM,24 h,3,32,35,1,0,0,0,NEU
BRD-A35153197_10uM_24h,BRD-A35153197,10 uM,24 h,3,25,28,1,34,8,26,NEU
BRD-K39172790_10uM_6h,BRD-K39172790,10 uM,6 h,3,47,50,1,4,4,0,NEU
hydroxytyrosol_10uM_6h,hydroxytyrosol,10 uM,6 h,3,47,50,1,4,3,1,NEU
tunicamycin_10uM_6h,tunicamycin,10 uM,6 h,3,29,32,1,21,17,4,NEU
BRD-K92326486_10uM_6h,BRD-K92326486,10 uM,6 h,3,47,50,1,5,3,2,NEU
BRD-K31342827_10uM_24h,BRD-K31342827,10 uM,24 h,3,24,27,1,117,44,73,NEU
WAY-405_10uM_6h,WAY-405,10 uM,6 h,3,47,50,1,3,1,2,NEU
BRD-A50388635_10uM_24h,BRD-A50388635,10 uM,24 h,3,32,35,1,1,0,1,NEU
STK-674938_10uM_24h,STK-674938,10 uM,24 h,3,32,35,1,0,0,0,NEU
BRD-K72505034_10uM_24h,BRD-K72505034,10 uM,24 h,3,32,35,1,6,2,4,NEU
BRD-K49403449_10uM_24h,BRD-K49403449,10 uM,24 h,3,32,35,1,2,0,2,NEU
SJB-AF-2_10uM_24h,SJB-AF-2,10 uM,24 h,3,32,35,1,4,2,2,NEU
BRD-K86693415_10uM_24h,BRD-K86693415,10 uM,24 h,3,32,35,1,2,0,2,NEU
BRD-K96403486_10uM_24h,BRD-K96403486,10 uM,24 h,3,32,35,1,10,5,5,NEU
BRD-A39986918_10uM_6h,BRD-A39986918,10 uM,6 h,3,47,50,1,2,2,0,NEU
BG-1006_10uM_24h,BG-1006,10 uM,24 h,3,24,27,1,361,189,172,NEU
BRD-A51916548_10uM_6h,BRD-A51916548,10 uM,6 h,3,47,50,1,0,0,0,NEU
BRD-M68558198_10uM_24h,BRD-M68558198,10 uM,24 h,3,25,28,1,18,5,13,NEU
BRD-A14999564_10uM_24h,BRD-A14999564,10 uM,24 h,3,25,28,1,7,3,4,NEU
OM-137_10uM_24h,OM-137,10 uM,24 h,3,32,35,1,1,0,1,NEU
BRD-K64885524_10uM_24h,BRD-K64885524,10 uM,24 h,3,32,35,1,0,0,0,NEU
ketocholesterol_10uM_24h,ketocholesterol,10 uM,24 h,3,24,27,1,5,1,4,NEU
KW-06_10uM_24h,KW-06,10 uM,24 h,3,25,28,1,21,7,14,NEU
BG-1008_10uM_24h,BG-1008,10 uM,24 h,3,24,27,1,307,151,156,NEU
BRD-A84423900_10uM_6h,BRD-A84423900,10 uM,6 h,3,47,50,1,3,1,2,NEU
BRD-K15181602_10uM_6h,BRD-K15181602,10 uM,6 h,3,47,50,1,1,1,0,NEU
lithium-chloride_10uM_24h,lithium-chloride,10 uM,24 h,3,24,27,1,43,6,37,NEU
rifampicin_10uM_6h,rifampicin,10 uM,6 h,3,29,32,1,0,0,0,NEU
BRD-K29345712_10uM_24h,BRD-K29345712,10 uM,24 h,3,32,35,1,4,3,1,NEU
BRD-K03670461_10uM_24h,BRD-K03670461,10 uM,24 h,3,32,35,1,0,0,0,NEU
STK-222600_10uM_24h,STK-222600,10 uM,24 h,3,32,35,1,0,0,0,NEU
BRD-A74767450_10uM_6h,BRD-A74767450,10 uM,6 h,3,47,50,1,0,0,0,NEU
AS-605240_10uM_6h,AS-605240,10 uM,6 h,3,29,32,1,0,0,0,NEU
BRD-M15189060_10uM_6h,BRD-M15189060,10 uM,6 h,3,47,50,1,0,0,0,NEU
velnacrine_10uM_6h,velnacrine,10 uM,6 h,3,47,50,1,0,0,0,NEU
BRD-M25555076_10uM_6h,BRD-M25555076,10 uM,6 h,3,47,50,1,0,0,0,NEU
BRD-A12426960_10uM_6h,BRD-A12426960,10 uM,6 h,3,47,50,1,0,0,0,NEU
diarylsulfonesulfonamide_10uM_6h,diarylsulfonesulfonamide,10 uM,6 h,3,29,32,1,0,0,0,NEU
dinorcitalopram-oxalate_10uM_6h,dinorcitalopram-oxalate,10 uM,6 h,3,47,50,1,0,0,0,NEU
BRD-K99667445_10uM_24h,BRD-K99667445,10 uM,24 h,3,24,27,1,15,2,13,NEU
lactotensin_10uM_6h,lactotensin,10 uM,6 h,3,47,50,1,0,0,0,NEU
BRD-M16214895_10uM_6h,BRD-M16214895,10 uM,6 h,3,47,50,1,2,1,1,NEU
GR-206_10uM_6h,GR-206,10 uM,6 h,3,29,32,1,0,0,0,NEU
BRD-A94494639_10uM_6h,BRD-A94494639,10 uM,6 h,3,47,50,1,1,1,0,NEU
BRD-K58070753_10uM_24h,BRD-K58070753,10 uM,24 h,3,32,35,1,1,1,0,NEU
BRD-K17628612_10uM_24h,BRD-K17628612,10 uM,24 h,3,32,35,1,0,0,0,NEU
BRD-K41220170_10uM_24h,BRD-K41220170,10 uM,24 h,3,32,35,1,1,1,0,NEU
calmidazolium_10uM_24h,calmidazolium,10 uM,24 h,3,20,23,1,1,0,1,NEU
BRD-K88964386_10uM_24h,BRD-K88964386,10 uM,24 h,3,32,35,1,2,1,1,NEU
GSK-2334470_10uM_24h,GSK-2334470,10 uM,24 h,3,65,68,1,6,6,0,NEU
BRD-K98336812_10uM_6h,BRD-K98336812,10 uM,6 h,3,47,50,1,1,1,0,NEU
BRD-U61360806_10uM_6h,BRD-U61360806,10 uM,6 h,3,29,32,1,0,0,0,NEU
BRD-K43807558_10uM_24h,BRD-K43807558,10 uM,24 h,3,25,28,1,34,10,24,NEU
BRD-M15189060_10uM_24h,BRD-M15189060,10 uM,24 h,3,25,28,1,1,1,0,NEU
KDM-103_10uM_24h,KDM-103,10 uM,24 h,3,25,28,1,199,55,144,NEU
BRD-K75181824_10uM_6h,BRD-K75181824,10 uM,6 h,3,29,32,1,0,0,0,NEU
BRD-A18795974_10uM_6h,BRD-A18795974,10 uM,6 h,3,47,50,1,0,0,0,NEU
EHNA_10uM_6h,EHNA,10 uM,6 h,3,29,32,1,0,0,0,NEU
BRD-K56622826_10uM_24h,BRD-K56622826,10 uM,24 h,3,25,28,1,2,0,2,NEU
BRD-K43631199_10uM_6h,BRD-K43631199,10 uM,6 h,3,47,50,1,1,1,0,NEU
BRD-K89997465_10uM_6h,BRD-K89997465,10 uM,6 h,3,47,50,1,6,5,1,NEU
BRD-K31344914_10uM_6h,BRD-K31344914,10 uM,6 h,3,47,50,1,5,2,3,NEU
BRD-K88710727_10uM_24h,BRD-K88710727,10 uM,24 h,3,32,35,1,1,0,1,NEU
alendronic-acid_10uM_24h,alendronic-acid,10 uM,24 h,3,25,28,1,1,0,1,NEU
BRD-K31342827_10uM_6h,BRD-K31342827,10 uM,6 h,3,29,32,1,48,17,31,NEU
trehalose_10uM_6h,trehalose,10 uM,6 h,3,29,32,1,0,0,0,NEU
dichlorobenzamil_10uM_24h,dichlorobenzamil,10 uM,24 h,3,25,28,1,3,2,1,NEU
BG-1024_10uM_6h,BG-1024,10 uM,6 h,3,29,32,1,33,26,7,NEU
BRD-K95895342_10uM_24h,BRD-K95895342,10 uM,24 h,3,32,35,1,2,2,0,NEU
BRD-K27237442_10uM_24h,BRD-K27237442,10 uM,24 h,3,25,28,1,1,0,1,NEU
QS-11_10uM_24h,QS-11,10 uM,24 h,3,24,27,1,0,0,0,NEU
BRD-A52530852_10uM_6h,BRD-A52530852,10 uM,6 h,3,47,50,1,0,0,0,NEU
BRD-K75971499_10uM_24h,BRD-K75971499,10 uM,24 h,3,25,28,1,120,45,75,NEU
BRD-K33445737_10uM_24h,BRD-K33445737,10 uM,24 h,3,25,28,1,175,49,126,NEU
BRD-K99554241_10uM_24h,BRD-K99554241,10 uM,24 h,3,25,28,1,1,1,0,NEU
BRD-K40094191_10uM_24h,BRD-K40094191,10 uM,24 h,3,32,35,1,2,1,1,NEU
BRD-K12168891_10uM_24h,BRD-K12168891,10 uM,24 h,3,32,35,1,0,0,0,NEU
BRD-K13794505_10uM_24h,BRD-K13794505,10 uM,24 h,3,32,35,1,10,4,6,NEU
BRD-K68588778_10uM_24h,BRD-K68588778,10 uM,24 h,3,32,35,1,12,8,4,NEU
kynuramine_10uM_24h,kynuramine,10 uM,24 h,3,32,35,1,4,1,3,NEU
IM-12_10uM_6h,IM-12,10 uM,6 h,3,29,32,1,1,0,1,NEU
NCH-51_10uM_24h,NCH-51,10 uM,24 h,3,24,27,1,403,171,232,NEU
BRD-A61866602_10uM_24h,BRD-A61866602,10 uM,24 h,3,25,28,1,2,0,2,NEU
BRD-K40167599_10uM_6h,BRD-K40167599,10 uM,6 h,3,47,50,1,3,3,0,NEU
GGTI-2133_10uM_6h,GGTI-2133,10 uM,6 h,3,47,50,1,4,3,1,NEU
WAY-405_10uM_24h,WAY-405,10 uM,24 h,3,25,28,1,2,1,1,NEU
MW-STK33-2C_10uM_24h,MW-STK33-2C,10 uM,24 h,3,32,35,1,10,3,7,NEU
apicidin_10uM_6h,apicidin,10 uM,6 h,3,19,22,1,251,135,116,NEU
BRD-A31180007_10uM_6h,BRD-A31180007,10 uM,6 h,3,47,50,1,7,2,5,NEU
BG-1017_10uM_24h,BG-1017,10 uM,24 h,3,24,27,1,2,1,1,NEU
CAY-10415_10uM_24h,CAY-10415,10 uM,24 h,3,32,35,1,1,0,1,NEU
BRD-K27170250_10uM_24h,BRD-K27170250,10 uM,24 h,3,32,35,1,25,10,15,NEU
BRD-A48349196_10uM_24h,BRD-A48349196,10 uM,24 h,3,25,28,1,0,0,0,NEU
BRD-K18573821_10uM_24h,BRD-K18573821,10 uM,24 h,3,25,28,1,2,1,1,NEU
EHPG-piperazine_10uM_6h,EHPG-piperazine,10 uM,6 h,3,47,50,1,0,0,0,NEU
BL-050_10uM_6h,BL-050,10 uM,6 h,3,29,32,1,0,0,0,NEU
BRD-K37365015_10uM_24h,BRD-K37365015,10 uM,24 h,3,25,28,1,37,21,16,NEU
gingerol_10uM_6h,gingerol,10 uM,6 h,3,29,32,1,0,0,0,NEU
SU-4312_10uM_24h,SU-4312,10 uM,24 h,3,32,35,1,0,0,0,NEU
ricinine_10uM_24h,ricinine,10 uM,24 h,3,32,35,1,27,6,21,NEU
BRD-A04172077_10uM_24h,BRD-A04172077,10 uM,24 h,3,32,35,1,0,0,0,NEU
BRD-K19875179_10uM_24h,BRD-K19875179,10 uM,24 h,3,32,35,1,0,0,0,NEU
BRD-K69458799_10uM_24h,BRD-K69458799,10 uM,24 h,3,25,28,1,0,0,0,NEU
n-methylphenothiazine_10uM_6h,n-methylphenothiazine,10 uM,6 h,3,47,50,1,2,1,1,NEU
BRD-K25701726_10uM_24h,BRD-K25701726,10 uM,24 h,3,25,28,1,0,0,0,NEU
BRD-A42994615_10uM_24h,BRD-A42994615,10 uM,24 h,3,24,27,1,1,1,0,NEU
BG-1015_10uM_24h,BG-1015,10 uM,24 h,3,24,27,1,215,89,126,NEU
BRD-A18795974_10uM_24h,BRD-A18795974,10 uM,24 h,3,25,28,1,4,0,4,NEU
BRD-K91781484_10uM_24h,BRD-K91781484,10 uM,24 h,3,25,28,1,0,0,0,NEU
BRD-K15181602_10uM_24h,BRD-K15181602,10 uM,24 h,3,25,28,1,0,0,0,NEU
BRD-K99554241_10uM_6h,BRD-K99554241,10 uM,6 h,3,47,50,1,1,1,0,NEU
BRD-K65411918_10uM_6h,BRD-K65411918,10 uM,6 h,3,29,32,1,0,0,0,NEU
BRD-K52453128_10uM_6h,BRD-K52453128,10 uM,6 h,3,47,50,1,3,2,1,NEU
BRD-K38720323_10uM_24h,BRD-K38720323,10 uM,24 h,3,25,28,1,3,1,2,NEU
L-732138_10uM_24h,L-732138,10 uM,24 h,3,32,35,1,0,0,0,NEU
BRD-K35307346_10uM_6h,BRD-K35307346,10 uM,6 h,3,29,32,1,7,1,6,NEU
BRD-K37365015_10uM_6h,BRD-K37365015,10 uM,6 h,3,47,50,1,16,11,5,NEU
BRD-A95074085_10uM_24h,BRD-A95074085,10 uM,24 h,3,24,27,1,0,0,0,NEU
IQ1_10uM_24h,IQ1,10 uM,24 h,3,24,27,1,19,3,16,NEU
mead-acid_10uM_24h,mead-acid,10 uM,24 h,3,32,35,1,0,0,0,NEU
BRD-K78603557_10uM_24h,BRD-K78603557,10 uM,24 h,3,32,35,1,0,0,0,NEU
BRD-K21165668_10uM_24h,BRD-K21165668,10 uM,24 h,3,32,35,1,0,0,0,NEU
BRD-K08307026_10uM_24h,BRD-K08307026,10 uM,24 h,3,32,35,1,112,36,76,NEU
BRD-A01295252_10uM_6h,BRD-A01295252,10 uM,6 h,3,47,50,1,3,2,1,NEU
BRD-A65140285_10uM_24h,BRD-A65140285,10 uM,24 h,3,25,28,1,0,0,0,NEU
BRD-K32307229_10uM_24h,BRD-K32307229,10 uM,24 h,3,24,27,1,134,34,100,NEU
BRD-K83068825_10uM_24h,BRD-K83068825,10 uM,24 h,3,25,28,1,104,46,58,NEU
6-nitrodopamine_10uM_24h,6-nitrodopamine,10 uM,24 h,3,25,28,1,0,0,0,NEU
BRD-K49889622_10uM_24h,BRD-K49889622,10 uM,24 h,3,25,28,1,1,1,0,NEU
BRD-K54822214_10uM_24h,BRD-K54822214,10 uM,24 h,3,32,35,1,0,0,0,NEU
BRD-K97951054_10uM_24h,BRD-K97951054,10 uM,24 h,3,32,35,1,3,1,2,NEU
BRD-K70947604_10uM_24h,BRD-K70947604,10 uM,24 h,3,32,35,1,0,0,0,NEU
BRD-K32949592_10uM_24h,BRD-K32949592,10 uM,24 h,3,32,35,1,1,0,1,NEU
BRD-K98064019_10uM_24h,BRD-K98064019,10 uM,24 h,3,32,35,1,4,2,2,NEU
BRD-K53472085_10uM_24h,BRD-K53472085,10 uM,24 h,3,32,35,1,0,0,0,NEU
BRD-K66224104_10uM_24h,BRD-K66224104,10 uM,24 h,3,32,35,1,0,0,0,NEU
cuneatin_10uM_24h,cuneatin,10 uM,24 h,3,32,35,1,16,4,12,NEU
BG-1023_10uM_6h,BG-1023,10 uM,6 h,3,29,32,1,1,1,0,NEU
BRD-K06209536_10uM_24h,BRD-K06209536,10 uM,24 h,3,25,28,1,31,7,24,NEU
epidepride_10uM_6h,epidepride,10 uM,6 h,3,47,50,1,1,1,0,NEU
BG-1006_10uM_6h,BG-1006,10 uM,6 h,3,29,32,1,117,59,58,NEU
NCI-16221_10uM_6h,NCI-16221,10 uM,6 h,3,29,32,1,0,0,0,NEU
BRD-K75516118_10uM_6h,BRD-K75516118,10 uM,6 h,3,29,32,1,0,0,0,NEU
BRD-M29370314_10uM_24h,BRD-M29370314,10 uM,24 h,3,25,28,1,0,0,0,NEU
BRD-K93859331_10uM_6h,BRD-K93859331,10 uM,6 h,3,47,50,1,1,0,1,NEU
ciclacillin_10uM_24h,ciclacillin,10 uM,24 h,3,32,35,1,2,0,2,NEU
BRD-K75329208_10uM_24h,BRD-K75329208,10 uM,24 h,3,32,35,1,11,5,6,NEU
BRD-K25070860_10uM_24h,BRD-K25070860,10 uM,24 h,3,32,35,1,2,0,2,NEU
BRD-K40367460_10uM_6h,BRD-K40367460,10 uM,6 h,3,47,50,1,1,1,0,NEU
BRD-K92159000_10uM_6h,BRD-K92159000,10 uM,6 h,3,47,50,1,1,1,0,NEU
BRD-K56994829_10uM_24h,BRD-K56994829,10 uM,24 h,3,25,28,1,47,9,38,NEU
1-methylisoquinoline_10uM_6h,1-methylisoquinoline,10 uM,6 h,3,47,50,1,0,0,0,NEU
anacardic-acid_10uM_6h,anacardic-acid,10 uM,6 h,3,29,32,1,0,0,0,NEU
triacetylresveratrol_10uM_6h,triacetylresveratrol,10 uM,6 h,3,29,32,1,0,0,0,NEU
SK-383933_10uM_6h,SK-383933,10 uM,6 h,3,47,50,1,2,1,1,NEU
BRD-K91844626_10uM_24h,BRD-K91844626,10 uM,24 h,3,25,28,1,46,11,35,NEU
YM-09151-2_10uM_6h,YM-09151-2,10 uM,6 h,3,47,50,1,1,1,0,NEU
prostaglandin-b2_10uM_24h,prostaglandin-b2,10 uM,24 h,3,32,35,1,0,0,0,NEU
KIN001-269_10uM_24h,KIN001-269,10 uM,24 h,3,65,68,1,1,1,0,NEU
paxilline_10uM_6h,paxilline,10 uM,6 h,3,29,32,1,0,0,0,NEU
BAY-K8644_10uM_6h,BAY-K8644,10 uM,6 h,3,29,32,1,1,1,0,NEU
BRD-K95767742_10uM_6h,BRD-K95767742,10 uM,6 h,3,47,50,1,1,1,0,NEU
SR-142948_10uM_24h,SR-142948,10 uM,24 h,3,25,28,1,23,8,15,NEU
BRD-K75128590_10uM_24h,BRD-K75128590,10 uM,24 h,3,32,35,1,3,1,2,NEU
BRD-K21672423_10uM_24h,BRD-K21672423,10 uM,24 h,3,32,35,1,1,0,1,NEU
BRD-K78559095_10uM_24h,BRD-K78559095,10 uM,24 h,3,32,35,1,6,3,3,NEU
BRD-K55591206_10uM_6h,BRD-K55591206,10 uM,6 h,3,29,32,1,0,0,0,NEU
benzohydroxamic-acid_10uM_24h,benzohydroxamic-acid,10 uM,24 h,3,24,27,1,3,0,3,NEU
methoprene-acid_10uM_6h,methoprene-acid,10 uM,6 h,3,29,32,1,0,0,0,NEU
BRD-K27237442_10uM_6h,BRD-K27237442,10 uM,6 h,3,47,50,1,1,1,0,NEU
H-8_10uM_24h,H-8,10 uM,24 h,3,32,35,1,1,1,0,NEU
BRD-K95676198_10uM_24h,BRD-K95676198,10 uM,24 h,3,32,35,1,0,0,0,NEU
BRD-K07850148_10uM_24h,BRD-K07850148,10 uM,24 h,3,32,35,1,0,0,0,NEU
BRD-M91737268_10uM_6h,BRD-M91737268,10 uM,6 h,3,47,50,1,0,0,0,NEU
BML-278_10uM_6h,BML-278,10 uM,6 h,3,29,32,1,1,0,1,NEU
BG-1012_10uM_24h,BG-1012,10 uM,24 h,3,24,27,1,0,0,0,NEU
SR-48692_10uM_24h,SR-48692,10 uM,24 h,3,25,28,1,7,1,6,NEU
beta-CCP_10uM_24h,beta-CCP,10 uM,24 h,3,32,35,1,1,0,1,NEU
BRD-K07653295_10uM_24h,BRD-K07653295,10 uM,24 h,3,25,28,1,30,2,28,NEU
BRD-K27803479_10uM_6h,BRD-K27803479,10 uM,6 h,3,47,50,1,8,8,0,NEU
BG-1008_10uM_6h,BG-1008,10 uM,6 h,3,29,32,1,111,58,53,NEU
BRD-A52647795_10uM_6h,BRD-A52647795,10 uM,6 h,3,47,50,1,2,2,0,NEU
BRD-U65466710_10uM_6h,BRD-U65466710,10 uM,6 h,3,47,50,1,6,2,4,NEU
propanoic-acid_10uM_24h,propanoic-acid,10 uM,24 h,3,25,28,1,1,0,1,NEU
BRD-A32582647_10uM_6h,BRD-A32582647,10 uM,6 h,3,47,50,1,2,2,0,NEU
BRD-A00150179_10uM_6h,BRD-A00150179,10 uM,6 h,3,47,50,1,1,0,1,NEU
SU-11652_10uM_6h,SU-11652,10 uM,6 h,3,29,32,1,85,17,68,NEU
BG-1009_10uM_6h,BG-1009,10 uM,6 h,3,29,32,1,0,0,0,NEU
bietaserpine_10uM_24h,bietaserpine,10 uM,24 h,3,25,28,1,62,15,47,NEU
BRD-K83355732_10uM_24h,BRD-K83355732,10 uM,24 h,3,32,35,1,13,10,3,NEU
BG-1022_10uM_6h,BG-1022,10 uM,6 h,3,29,32,1,6,6,0,NEU
BRD-A39986918_10uM_24h,BRD-A39986918,10 uM,24 h,3,25,28,1,13,2,11,NEU
BRD-K80062189_10uM_6h,BRD-K80062189,10 uM,6 h,3,47,50,1,0,0,0,NEU
BRD-K84252391_10uM_24h,BRD-K84252391,10 uM,24 h,3,25,28,1,2,0,2,NEU
BRD-K58930050_10uM_24h,BRD-K58930050,10 uM,24 h,3,25,28,1,0,0,0,NEU
BRD-K02701279_10uM_24h,BRD-K02701279,10 uM,24 h,3,32,35,1,0,0,0,NEU
BRD-A49680073_10uM_24h,BRD-A49680073,10 uM,24 h,3,32,35,1,1,1,0,NEU
RAN-14A_10uM_24h,RAN-14A,10 uM,24 h,3,32,35,1,1,1,0,NEU
testosterone_10uM_24h,testosterone,10 uM,24 h,3,32,35,1,0,0,0,NEU
BRD-K79619196_10uM_24h,BRD-K79619196,10 uM,24 h,3,32,35,1,3,1,2,NEU
BRD-A22272113_10uM_24h,BRD-A22272113,10 uM,24 h,3,32,35,1,0,0,0,NEU
BRD-K59980915_10uM_24h,BRD-K59980915,10 uM,24 h,3,32,35,1,0,0,0,NEU
BRD-K37883585_10uM_24h,BRD-K37883585,10 uM,24 h,3,32,35,1,0,0,0,NEU
butyrolactone_10uM_24h,butyrolactone,10 uM,24 h,3,24,27,1,43,13,30,NEU
BRD-K24307074_10uM_6h,BRD-K24307074,10 uM,6 h,3,47,50,1,2,2,0,NEU
BG-1018_10uM_6h,BG-1018,10 uM,6 h,3,29,32,1,7,7,0,NEU
BRD-U57440914_10uM_6h,BRD-U57440914,10 uM,6 h,3,47,50,1,1,1,0,NEU
BG-1013_10uM_24h,BG-1013,10 uM,24 h,3,24,27,1,14,9,5,NEU
Val-Val-Val_10uM_24h,Val-Val-Val,10 uM,24 h,3,24,27,1,76,18,58,NEU
BRD-A75769921_10uM_6h,BRD-A75769921,10 uM,6 h,3,47,50,1,7,4,3,NEU
BRD-K42823101_10uM_6h,BRD-K42823101,10 uM,6 h,3,47,50,1,1,1,0,NEU
BRD-K24304282_10uM_24h,BRD-K24304282,10 uM,24 h,3,25,28,1,7,0,7,NEU
flavanone_10uM_6h,flavanone,10 uM,6 h,3,29,32,1,0,0,0,NEU
BRD-U85918428_10uM_6h,BRD-U85918428,10 uM,6 h,3,47,50,1,3,0,3,NEU
BG-1014_10uM_24h,BG-1014,10 uM,24 h,3,24,27,1,1,1,0,NEU
SKF-83959_10uM_6h,SKF-83959,10 uM,6 h,3,47,50,1,4,1,3,NEU
SA-1447005_10uM_24h,SA-1447005,10 uM,24 h,3,32,35,1,3,1,2,NEU
BRD-K31553917_10uM_24h,BRD-K31553917,10 uM,24 h,3,32,35,1,2,1,1,NEU
BRD-K00944562_10uM_24h,BRD-K00944562,10 uM,24 h,3,32,35,1,8,5,3,NEU
desmethyl-DASB_10uM_24h,desmethyl-DASB,10 uM,24 h,3,25,28,1,0,0,0,NEU
BRD-A41986761_10uM_24h,BRD-A41986761,10 uM,24 h,3,25,28,1,0,0,0,NEU
APEC_10uM_6h,APEC,10 uM,6 h,3,47,50,1,0,0,0,NEU
BRD-K03608458_10uM_24h,BRD-K03608458,10 uM,24 h,3,25,28,1,98,32,66,NEU
BRD-K33445737_10uM_6h,BRD-K33445737,10 uM,6 h,3,47,50,1,92,33,59,NEU
BRD-K24031526_10uM_24h,BRD-K24031526,10 uM,24 h,3,32,35,1,1,1,0,NEU
BRD-K05775306_10uM_24h,BRD-K05775306,10 uM,24 h,3,32,35,1,0,0,0,NEU
CGS-12066B_10uM_24h,CGS-12066B,10 uM,24 h,3,32,35,1,11,5,6,NEU
BRD-A67306036_10uM_24h,BRD-A67306036,10 uM,24 h,3,32,35,1,0,0,0,NEU
BRD-K23313025_10uM_24h,BRD-K23313025,10 uM,24 h,3,32,35,1,0,0,0,NEU
BRD-K72015216_10uM_6h,BRD-K72015216,10 uM,6 h,3,47,50,1,2,2,0,NEU
BAY-K8644_10uM_24h,BAY-K8644,10 uM,24 h,3,24,27,1,112,17,95,NEU
BRD-K71339761_10uM_24h,BRD-K71339761,10 uM,24 h,3,25,28,1,18,8,10,NEU
BRD-K03736784_10uM_24h,BRD-K03736784,10 uM,24 h,3,32,35,1,236,58,178,NEU
BRD-K53249762_10uM_6h,BRD-K53249762,10 uM,6 h,3,47,50,1,2,0,2,NEU
isosalsoline_10uM_6h,isosalsoline,10 uM,6 h,3,47,50,1,0,0,0,NEU
chrysamine-g_10uM_24h,chrysamine-g,10 uM,24 h,3,25,28,1,5,2,3,NEU
BRD-A24951056_10uM_6h,BRD-A24951056,10 uM,6 h,3,47,50,1,5,3,2,NEU
BRD-K43014159_10uM_24h,BRD-K43014159,10 uM,24 h,3,25,28,1,0,0,0,NEU
BRD-K52453128_10uM_24h,BRD-K52453128,10 uM,24 h,3,25,28,1,0,0,0,NEU
terreic-acid_10uM_6h,terreic-acid,10 uM,6 h,3,29,32,1,36,23,13,NEU
BRD-K39172790_10uM_24h,BRD-K39172790,10 uM,24 h,3,25,28,1,320,99,221,NEU
BRD-A79058669_10uM_6h,BRD-A79058669,10 uM,6 h,3,47,50,1,1,1,0,NEU
BRD-K89997465_10uM_24h,BRD-K89997465,10 uM,24 h,3,25,28,1,8,5,3,NEU
BRD-K96752129_10uM_24h,BRD-K96752129,10 uM,24 h,3,32,35,1,2,2,0,NEU
bisindolylmaleimide-ix_10uM_24h,bisindolylmaleimide-ix,10 uM,24 h,3,32,35,1,258,81,177,NEU
BAS-00594560_10uM_24h,BAS-00594560,10 uM,24 h,3,32,35,1,4,1,3,NEU
BRD-K72615639_10uM_24h,BRD-K72615639,10 uM,24 h,3,32,35,1,5,5,0,NEU
dephostatin_10uM_24h,dephostatin,10 uM,24 h,3,32,35,1,0,0,0,NEU
BRD-A78236793_10uM_6h,BRD-A78236793,10 uM,6 h,3,47,50,1,44,28,16,NEU
BRD-A92334183_10uM_24h,BRD-A92334183,10 uM,24 h,3,25,28,1,76,18,58,NEU
BRD-A70541707_10uM_24h,BRD-A70541707,10 uM,24 h,3,25,28,1,56,31,25,NEU
BG-1028_10uM_6h,BG-1028,10 uM,6 h,3,29,32,1,149,86,63,NEU
BRD-K02223034_10uM_24h,BRD-K02223034,10 uM,24 h,3,32,35,1,4,2,2,NEU
BRD-K91671201_10uM_24h,BRD-K91671201,10 uM,24 h,3,32,35,1,1,1,0,NEU
mammea-a_10uM_24h,mammea-a,10 uM,24 h,3,32,35,1,0,0,0,NEU
BRD-K11883928_10uM_24h,BRD-K11883928,10 uM,24 h,3,32,35,1,0,0,0,NEU
BRD-K92863101_10uM_24h,BRD-K92863101,10 uM,24 h,3,32,35,1,10,5,5,NEU
BRD-K95080859_10uM_24h,BRD-K95080859,10 uM,24 h,3,32,35,1,5,1,4,NEU
BRD-K47703442_10uM_24h,BRD-K47703442,10 uM,24 h,3,32,35,1,4,4,0,NEU
AZD-1480_10uM_24h,AZD-1480,10 uM,24 h,3,65,68,1,4,1,3,NEU
BRD-K13528168_10uM_6h,BRD-K13528168,10 uM,6 h,3,47,50,1,2,1,1,NEU
niguldipine_10uM_24h,niguldipine,10 uM,24 h,3,24,27,1,301,109,192,NEU
TUL-XIX029_10uM_24h,TUL-XIX029,10 uM,24 h,3,32,35,1,0,0,0,NEU
BRD-K90446118_10uM_24h,BRD-K90446118,10 uM,24 h,3,32,35,1,0,0,0,NEU
BRD-K27803479_10uM_24h,BRD-K27803479,10 uM,24 h,3,25,28,1,20,7,13,NEU
BRD-A35072120_10uM_6h,BRD-A35072120,10 uM,6 h,3,47,50,1,0,0,0,NEU
BRD-K59488055_10uM_24h,BRD-K59488055,10 uM,24 h,3,32,35,1,3,2,1,NEU
BRD-K51791390_10uM_24h,BRD-K51791390,10 uM,24 h,3,32,35,1,0,0,0,NEU
BRD-A01960364_10uM_24h,BRD-A01960364,10 uM,24 h,3,32,35,1,70,35,35,NEU
epothilone_10uM_24h,epothilone,10 uM,24 h,3,32,35,1,1,1,0,NEU
IQ1_10uM_6h,IQ1,10 uM,6 h,3,29,32,1,9,2,7,NEU
alendronic-acid_10uM_6h,alendronic-acid,10 uM,6 h,3,47,50,1,1,1,0,NEU
BRD-A40163033_10uM_24h,BRD-A40163033,10 uM,24 h,3,25,28,1,0,0,0,NEU
desmethyl-DASB_10uM_6h,desmethyl-DASB,10 uM,6 h,3,47,50,1,1,1,0,NEU
BRD-K11362964_10uM_24h,BRD-K11362964,10 uM,24 h,3,32,35,1,3,2,1,NEU
BRD-K52831896_10uM_24h,BRD-K52831896,10 uM,24 h,3,32,35,1,2,0,2,NEU
BRD-K91987625_10uM_24h,BRD-K91987625,10 uM,24 h,3,32,35,1,1,1,0,NEU
BRD-A06276885_10uM_24h,BRD-A06276885,10 uM,24 h,3,32,35,1,12,6,6,NEU
BRD-K84421793_10uM_24h,BRD-K84421793,10 uM,24 h,3,32,35,1,1,0,1,NEU
BRD-A52530852_10uM_24h,BRD-A52530852,10 uM,24 h,3,25,28,1,1,0,1,NEU
BRD-K18573821_10uM_6h,BRD-K18573821,10 uM,6 h,3,47,50,1,0,0,0,NEU
TCPOBOP_10uM_6h,TCPOBOP,10 uM,6 h,3,29,32,1,0,0,0,NEU
BRD-A35825362_10uM_24h,BRD-A35825362,10 uM,24 h,3,25,28,1,0,0,0,NEU
BRD-K03608458_10uM_6h,BRD-K03608458,10 uM,6 h,3,47,50,1,29,22,7,NEU
BRD-K58901278_10uM_24h,BRD-K58901278,10 uM,24 h,3,25,28,1,5,4,1,NEU
BML-278_10uM_24h,BML-278,10 uM,24 h,3,24,27,1,15,3,12,NEU
trans-bis-q_10uM_6h,trans-bis-q,10 uM,6 h,3,47,50,1,7,4,3,NEU
BRD-K83161876_10uM_6h,BRD-K83161876,10 uM,6 h,3,47,50,1,0,0,0,NEU
W-5_10uM_24h,W-5,10 uM,24 h,3,25,28,1,0,0,0,NEU
BRD-K97330509_10uM_24h,BRD-K97330509,10 uM,24 h,3,32,35,1,0,0,0,NEU
BRD-K14704318_10uM_24h,BRD-K14704318,10 uM,24 h,3,32,35,1,0,0,0,NEU
VU-0418946-1_10uM_24h,VU-0418946-1,10 uM,24 h,3,32,35,1,54,29,25,NEU
PD-149163_10uM_24h,PD-149163,10 uM,24 h,3,25,28,1,0,0,0,NEU
BRD-A09053961_10uM_24h,BRD-A09053961,10 uM,24 h,3,25,28,1,8,3,5,NEU
ITSA-1_10uM_6h,ITSA-1,10 uM,6 h,3,29,32,1,0,0,0,NEU
BRD-K06020002_10uM_24h,BRD-K06020002,10 uM,24 h,3,32,35,1,0,0,0,NEU
MW-STK33-3A_10uM_24h,MW-STK33-3A,10 uM,24 h,3,32,35,1,2,1,1,NEU
BRD-A92800748_10uM_24h,BRD-A92800748,10 uM,24 h,3,65,68,1,0,0,0,NEU
BRD-K69501658_10uM_24h,BRD-K69501658,10 uM,24 h,3,32,35,1,4,3,1,NEU
BRD-K37618507_10uM_24h,BRD-K37618507,10 uM,24 h,3,32,35,1,5,4,1,NEU
BRD-K62169556_10uM_24h,BRD-K62169556,10 uM,24 h,3,32,35,1,6,5,1,NEU
taurodeoxycholic-acid_10uM_6h,taurodeoxycholic-acid,10 uM,6 h,3,29,32,1,1,1,0,NEU
BRD-K64024097_10uM_6h,BRD-K64024097,10 uM,6 h,3,29,32,1,0,0,0,NEU
BRD-A08027849_10uM_6h,BRD-A08027849,10 uM,6 h,3,29,32,1,0,0,0,NEU
L-741626_10uM_24h,L-741626,10 uM,24 h,3,32,35,1,0,0,0,NEU
ST-012015_10uM_24h,ST-012015,10 uM,24 h,3,32,35,1,1,1,0,NEU
BG-1027_10uM_6h,BG-1027,10 uM,6 h,3,29,32,1,152,85,67,NEU
butyrolactone_10uM_6h,butyrolactone,10 uM,6 h,3,29,32,1,0,0,0,NEU
BRD-K33392208_10uM_24h,BRD-K33392208,10 uM,24 h,3,32,35,1,16,9,7,NEU
VU-0418933-1_10uM_24h,VU-0418933-1,10 uM,24 h,3,32,35,1,6,4,2,NEU
CAY-10578_10uM_24h,CAY-10578,10 uM,24 h,3,32,35,1,0,0,0,NEU
BRD-K81795824_10uM_24h,BRD-K81795824,10 uM,24 h,3,32,35,1,12,9,3,NEU
BRD-K01192156_10uM_6h,BRD-K01192156,10 uM,6 h,3,29,32,1,0,0,0,NEU
BRD-K28308851_10uM_24h,BRD-K28308851,10 uM,24 h,3,25,28,1,0,0,0,NEU
purpurogallin_10uM_24h,purpurogallin,10 uM,24 h,3,24,27,1,0,0,0,NEU
HDAC1-selective_10uM_6h,HDAC1-selective,10 uM,6 h,3,29,32,1,0,0,0,NEU
BRD-K27332342_10uM_6h,BRD-K27332342,10 uM,6 h,3,29,32,1,8,2,6,NEU
bafilomycin_10uM_24h,bafilomycin,10 uM,24 h,3,24,27,1,89,30,59,NEU
BRD-A77098556_10uM_24h,BRD-A77098556,10 uM,24 h,3,25,28,1,35,13,22,NEU
BRD-A70541707_10uM_6h,BRD-A70541707,10 uM,6 h,3,47,50,1,29,25,4,NEU
BRD-K37727696_10uM_24h,BRD-K37727696,10 uM,24 h,3,32,35,1,0,0,0,NEU
BRD-K37762845_10uM_24h,BRD-K37762845,10 uM,24 h,3,32,35,1,0,0,0,NEU
BRD-K33211335_10uM_24h,BRD-K33211335,10 uM,24 h,3,32,35,1,2,1,1,NEU
BRD-U57440914_10uM_24h,BRD-U57440914,10 uM,24 h,3,25,28,1,77,35,42,NEU
epidepride_10uM_24h,epidepride,10 uM,24 h,3,25,28,1,1,0,1,NEU
BG-1003_10uM_24h,BG-1003,10 uM,24 h,3,25,28,1,227,92,135,NEU
BRD-K99636700_10uM_6h,BRD-K99636700,10 uM,6 h,3,29,32,1,23,10,13,NEU
glycocholic-acid_10uM_6h,glycocholic-acid,10 uM,6 h,3,29,32,1,0,0,0,NEU
valproxam_10uM_24h,valproxam,10 uM,24 h,3,24,27,1,0,0,0,NEU
BRD-K83872150_10uM_24h,BRD-K83872150,10 uM,24 h,3,24,27,1,87,21,66,NEU
YM-09151-2_10uM_24h,YM-09151-2,10 uM,24 h,3,25,28,1,0,0,0,NEU
z-guggulsterone_10uM_6h,z-guggulsterone,10 uM,6 h,3,29,32,1,0,0,0,NEU
BRD-K20986251_10uM_6h,BRD-K20986251,10 uM,6 h,3,29,32,1,0,0,0,NEU
BRD-K16051505_10uM_24h,BRD-K16051505,10 uM,24 h,3,32,35,1,0,0,0,NEU
BRD-K10609180_10uM_24h,BRD-K10609180,10 uM,24 h,3,32,35,1,21,16,5,NEU
BRD-K21788104_10uM_24h,BRD-K21788104,10 uM,24 h,3,32,35,1,2,0,2,NEU
BRD-K95992530_10uM_24h,BRD-K95992530,10 uM,24 h,3,32,35,1,0,0,0,NEU
BRD-K96527333_10uM_24h,BRD-K96527333,10 uM,24 h,3,32,35,1,0,0,0,NEU
BRD-K31460632_10uM_24h,BRD-K31460632,10 uM,24 h,3,25,28,1,2,2,0,NEU
kavain_10uM_6h,kavain,10 uM,6 h,3,47,50,1,0,0,0,NEU
mevalonic-acid_10uM_24h,mevalonic-acid,10 uM,24 h,3,25,28,1,0,0,0,NEU
BRD-K63116520_10uM_24h,BRD-K63116520,10 uM,24 h,3,25,28,1,0,0,0,NEU
LBH-589_10uM_6h,LBH-589,10 uM,6 h,3,47,50,1,190,140,50,NEU
BRD-K11981252_10uM_24h,BRD-K11981252,10 uM,24 h,3,32,35,1,2,1,1,NEU
SPB02137_10uM_24h,SPB02137,10 uM,24 h,3,32,35,1,184,77,107,NEU
RAF-265_10uM_24h,RAF-265,10 uM,24 h,3,65,68,1,9,8,1,NEU
BAS-02859604_10uM_24h,BAS-02859604,10 uM,24 h,3,32,35,1,2,2,0,NEU
BRD-A01295252_10uM_24h,BRD-A01295252,10 uM,24 h,3,25,28,1,1,0,1,NEU
BRD-A31180007_10uM_24h,BRD-A31180007,10 uM,24 h,3,25,28,1,277,72,205,NEU
brefeldin-a_10uM_6h,brefeldin-a,10 uM,6 h,3,29,32,1,9,3,6,NEU
BRD-K64729807_10uM_24h,BRD-K64729807,10 uM,24 h,3,24,27,1,0,0,0,NEU
BRD-K23628492_10uM_6h,BRD-K23628492,10 uM,6 h,3,47,50,1,0,0,0,NEU
BRD-A65771317_10uM_6h,BRD-A65771317,10 uM,6 h,3,47,50,1,3,1,2,NEU
BRD-K43069600_10uM_24h,BRD-K43069600,10 uM,24 h,3,32,35,1,0,0,0,NEU
BRD-K61717269_10uM_24h,BRD-K61717269,10 uM,24 h,3,32,35,1,59,19,40,NEU
BRD-K07223205_10uM_24h,BRD-K07223205,10 uM,24 h,3,25,28,1,26,9,17,NEU
taurocholic-acid_10uM_6h,taurocholic-acid,10 uM,6 h,3,29,32,1,0,0,0,NEU
BRD-K97808269_10uM_6h,BRD-K97808269,10 uM,6 h,3,29,32,1,0,0,0,NEU
GGTI-2133_10uM_24h,GGTI-2133,10 uM,24 h,3,25,28,1,0,0,0,NEU
seneciphylline_10uM_24h,seneciphylline,10 uM,24 h,3,32,35,1,0,0,0,NEU
BRD-K41652870_10uM_24h,BRD-K41652870,10 uM,24 h,3,32,35,1,5,4,1,NEU
umbelliferone_10uM_24h,umbelliferone,10 uM,24 h,3,32,35,1,5,2,3,NEU
BG-1015_10uM_6h,BG-1015,10 uM,6 h,3,29,32,1,0,0,0,NEU
farnesylthioacetic-acid_10uM_24h,farnesylthioacetic-acid,10 uM,24 h,3,24,27,1,0,0,0,NEU
BG-1029_10uM_6h,BG-1029,10 uM,6 h,3,29,32,1,163,101,62,NEU
aminobenztropine_10uM_6h,aminobenztropine,10 uM,6 h,3,47,50,1,3,1,2,NEU
KIN001-260_10uM_24h,KIN001-260,10 uM,24 h,3,65,68,1,0,0,0,NEU
BRD-K90849765_10uM_24h,BRD-K90849765,10 uM,24 h,3,32,35,1,2,1,1,NEU
benzohydroxamic-acid_10uM_6h,benzohydroxamic-acid,10 uM,6 h,3,29,32,1,0,0,0,NEU
BRD-K19653414_10uM_24h,BRD-K19653414,10 uM,24 h,3,25,28,1,1,1,0,NEU
BRD-K47535255_10uM_6h,BRD-K47535255,10 uM,6 h,3,47,50,1,11,8,3,NEU
tetramethylsilane_10uM_24h,tetramethylsilane,10 uM,24 h,3,32,35,1,0,0,0,NEU
BRD-K98004941_10uM_24h,BRD-K98004941,10 uM,24 h,3,32,35,1,0,0,0,NEU
BRD-K15475572_10uM_24h,BRD-K15475572,10 uM,24 h,3,32,35,1,6,3,3,NEU
BRD-K98731749_10uM_24h,BRD-K98731749,10 uM,24 h,3,32,35,1,28,15,13,NEU
BRD-A17081056_10uM_24h,BRD-A17081056,10 uM,24 h,3,25,28,1,67,15,52,NEU
p-aminophenethylspiperone_10uM_6h,p-aminophenethylspiperone,10 uM,6 h,3,47,50,1,20,18,2,NEU
BRD-M28563253_10uM_6h,BRD-M28563253,10 uM,6 h,3,47,50,1,1,1,0,NEU
aminoresveratrol_10uM_6h,aminoresveratrol,10 uM,6 h,3,29,32,1,63,28,35,NEU
BRD-K18436203_10uM_24h,BRD-K18436203,10 uM,24 h,3,25,28,1,2,0,2,NEU
DY-44_10uM_24h,DY-44,10 uM,24 h,3,32,35,1,5,3,2,NEU
BRD-K03857568_10uM_24h,BRD-K03857568,10 uM,24 h,3,32,35,1,9,6,3,NEU
BRD-K97701319_10uM_24h,BRD-K97701319,10 uM,24 h,3,32,35,1,4,3,1,NEU
BRD-A95074085_10uM_6h,BRD-A95074085,10 uM,6 h,3,29,32,1,1,1,0,NEU
paxilline_10uM_24h,paxilline,10 uM,24 h,3,24,27,1,23,3,20,NEU
BRD-K25701726_10uM_6h,BRD-K25701726,10 uM,6 h,3,47,50,1,0,0,0,NEU
BG-1022_10uM_24h,BG-1022,10 uM,24 h,3,24,27,1,2,1,1,NEU
BG-1020_10uM_6h,BG-1020,10 uM,6 h,3,29,32,1,0,0,0,NEU
BRD-K94158209_10uM_24h,BRD-K94158209,10 uM,24 h,3,25,28,1,0,0,0,NEU
BRD-K70980943_10uM_6h,BRD-K70980943,10 uM,6 h,3,47,50,1,0,0,0,NEU
irilin-a_10uM_24h,irilin-a,10 uM,24 h,3,32,35,1,5,3,2,NEU
BRD-K06652922_10uM_24h,BRD-K06652922,10 uM,24 h,3,32,35,1,0,0,0,NEU
BRD-A79058669_10uM_24h,BRD-A79058669,10 uM,24 h,3,25,28,1,0,0,0,NEU
BRD-A82323890_10uM_6h,BRD-A82323890,10 uM,6 h,3,47,50,1,3,2,1,NEU
BAS-00535043_10uM_24h,BAS-00535043,10 uM,24 h,3,32,35,1,3,2,1,NEU
BRD-K55715339_10uM_24h,BRD-K55715339,10 uM,24 h,3,32,35,1,0,0,0,NEU
reserpic-acid_10uM_24h,reserpic-acid,10 uM,24 h,3,32,35,1,1,0,1,NEU
BRD-K86110682_10uM_24h,BRD-K86110682,10 uM,24 h,3,32,35,1,0,0,0,NEU
PMSF_10uM_6h,PMSF,10 uM,6 h,3,29,32,1,1,0,1,NEU
alitretinoin_10uM_6h,alitretinoin,10 uM,6 h,3,29,32,1,2,1,1,NEU
BRD-K61894884_10uM_6h,BRD-K61894884,10 uM,6 h,3,29,32,1,0,0,0,NEU
n-bromoacetyltryptamine_10uM_24h,n-bromoacetyltryptamine,10 uM,24 h,3,25,28,1,160,54,106,NEU
z-guggulsterone_10uM_24h,z-guggulsterone,10 uM,24 h,3,24,27,1,1,1,0,NEU
BRD-K95847244_10uM_6h,BRD-K95847244,10 uM,6 h,3,47,50,1,0,0,0,NEU
methyltyramine_10uM_24h,methyltyramine,10 uM,24 h,3,25,28,1,0,0,0,NEU
HU-211_10uM_24h,HU-211,10 uM,24 h,3,32,35,1,190,74,116,NEU
BRD-K68191033_10uM_24h,BRD-K68191033,10 uM,24 h,3,32,35,1,0,0,0,NEU
GGTI-297_10uM_6h,GGTI-297,10 uM,6 h,3,47,50,1,4,3,1,NEU
DASB_10uM_6h,DASB,10 uM,6 h,3,47,50,1,0,0,0,NEU
oxamflatin_10uM_24h,oxamflatin,10 uM,24 h,3,24,27,1,386,188,198,NEU
BRD-K50311478_10uM_24h,BRD-K50311478,10 uM,24 h,3,32,35,1,0,0,0,NEU
BRD-A27924917_10uM_24h,BRD-A27924917,10 uM,24 h,3,25,28,1,1,1,0,NEU
salsolinol_10uM_6h,salsolinol,10 uM,6 h,3,47,50,1,6,6,0,NEU
BRD-K91781484_10uM_6h,BRD-K91781484,10 uM,6 h,3,47,50,1,2,2,0,NEU
dihydrocapsaicin_10uM_6h,dihydrocapsaicin,10 uM,6 h,3,29,32,1,0,0,0,NEU
BRD-K96043519_10uM_6h,BRD-K96043519,10 uM,6 h,3,47,50,1,4,3,1,NEU
dihydrosamidin_10uM_24h,dihydrosamidin,10 uM,24 h,3,32,35,1,1,1,0,NEU
BRD-A72837804_10uM_24h,BRD-A72837804,10 uM,24 h,3,32,35,1,4,2,2,NEU
BRD-K41429297_10uM_24h,BRD-K41429297,10 uM,24 h,3,32,35,1,0,0,0,NEU
BRD-K38690464_10uM_24h,BRD-K38690464,10 uM,24 h,3,32,35,1,0,0,0,NEU
EMD-84_10uM_24h,EMD-84,10 uM,24 h,3,32,35,1,0,0,0,NEU
BRD-K14790374_10uM_24h,BRD-K14790374,10 uM,24 h,3,32,35,1,0,0,0,NEU
BRD-K54729176_10uM_24h,BRD-K54729176,10 uM,24 h,3,24,27,1,26,17,9,NEU
BRD-A14795281_10uM_6h,BRD-A14795281,10 uM,6 h,3,47,50,1,1,1,0,NEU
BRD-A35072120_10uM_24h,BRD-A35072120,10 uM,24 h,3,25,28,1,3,1,2,NEU
QS-11_10uM_6h,QS-11,10 uM,6 h,3,29,32,1,1,0,1,NEU
ergocornine_10uM_24h,ergocornine,10 uM,24 h,3,32,35,1,0,0,0,NEU
indolophenanthridine_10uM_24h,indolophenanthridine,10 uM,24 h,3,32,35,1,3,2,1,NEU
NS-1619_10uM_24h,NS-1619,10 uM,24 h,3,32,35,1,0,0,0,NEU
BRD-K12238169_10uM_24h,BRD-K12238169,10 uM,24 h,3,32,35,1,0,0,0,NEU
BRD-K95253417_10uM_24h,BRD-K95253417,10 uM,24 h,3,32,35,1,0,0,0,NEU
BRD-A69454249_10uM_6h,BRD-A69454249,10 uM,6 h,3,47,50,1,11,8,3,NEU
aminobenztropine_10uM_24h,aminobenztropine,10 uM,24 h,3,25,28,1,56,18,38,NEU
beta-alanine_10uM_6h,beta-alanine,10 uM,6 h,3,47,50,1,3,2,1,NEU
MW-STK33-4A_10uM_24h,MW-STK33-4A,10 uM,24 h,3,32,35,1,3,3,0,NEU
BRD-K16346331_10uM_24h,BRD-K16346331,10 uM,24 h,3,32,35,1,3,2,1,NEU
BRD-A36165599_10uM_24h,BRD-A36165599,10 uM,24 h,3,32,35,1,10,4,6,NEU
BRD-K47825575_10uM_24h,BRD-K47825575,10 uM,24 h,3,32,35,1,0,0,0,NEU
ISOX_10uM_6h,ISOX,10 uM,6 h,3,29,32,1,165,111,54,NEU
BG-1019_10uM_24h,BG-1019,10 uM,24 h,3,24,27,1,33,16,17,NEU
BRD-K45845523_10uM_24h,BRD-K45845523,10 uM,24 h,3,25,28,1,0,0,0,NEU
BRD-K20985754_10uM_6h,BRD-K20985754,10 uM,6 h,3,47,50,1,3,2,1,NEU
BRD-K95767742_10uM_24h,BRD-K95767742,10 uM,24 h,3,25,28,1,0,0,0,NEU
BRD-K15250199_10uM_24h,BRD-K15250199,10 uM,24 h,3,32,35,1,6,4,2,NEU
BRD-K50659736_10uM_24h,BRD-K50659736,10 uM,24 h,3,32,35,1,0,0,0,NEU
BRD-K42091312_10uM_24h,BRD-K42091312,10 uM,24 h,3,32,35,1,1,1,0,NEU
2-aminotetralin_10uM_24h,2-aminotetralin,10 uM,24 h,3,25,28,1,45,10,35,NEU
BRD-A12426960_10uM_24h,BRD-A12426960,10 uM,24 h,3,25,28,1,8,1,7,NEU
trans-bis-q_10uM_24h,trans-bis-q,10 uM,24 h,3,25,28,1,1,0,1,NEU
BRD-K96043519_10uM_24h,BRD-K96043519,10 uM,24 h,3,25,28,1,23,7,16,NEU
BRD-K58901278_10uM_6h,BRD-K58901278,10 uM,6 h,3,47,50,1,0,0,0,NEU
BRD-K59915259_10uM_6h,BRD-K59915259,10 uM,6 h,3,47,50,1,1,1,0,NEU
BRD-K79052598_10uM_24h,BRD-K79052598,10 uM,24 h,3,25,28,1,0,0,0,NEU
BRD-K33676730_10uM_24h,BRD-K33676730,10 uM,24 h,3,32,35,1,3,1,2,NEU
denbufylline_10uM_24h,denbufylline,10 uM,24 h,3,32,35,1,1,0,1,NEU
Z-36_10uM_6h,Z-36,10 uM,6 h,3,29,32,1,50,25,25,NEU
ITSA-1_10uM_24h,ITSA-1,10 uM,24 h,3,24,27,1,0,0,0,NEU
BRD-K75516118_10uM_24h,BRD-K75516118,10 uM,24 h,3,24,27,1,1,0,1,NEU
LY-294002_10uM_6h,LY-294002,10 uM,6 h,3,29,32,1,4,3,1,NEU
BRD-K41824522_10uM_24h,BRD-K41824522,10 uM,24 h,3,25,28,1,1,0,1,NEU
NCI-16221_10uM_24h,NCI-16221,10 uM,24 h,3,24,27,1,3,1,2,NEU
SU-1498_10uM_24h,SU-1498,10 uM,24 h,3,32,35,1,2,1,1,NEU
AG-957_10uM_24h,AG-957,10 uM,24 h,3,32,35,1,0,0,0,NEU
BRD-K95976153_10uM_24h,BRD-K95976153,10 uM,24 h,3,32,35,1,6,3,3,NEU
BRD-K36651625_10uM_6h,BRD-K36651625,10 uM,6 h,3,47,50,1,1,1,0,NEU
BG-1010_10uM_24h,BG-1010,10 uM,24 h,3,24,27,1,129,62,67,NEU
BRD-K71339761_10uM_6h,BRD-K71339761,10 uM,6 h,3,47,50,1,7,4,3,NEU
BRD-K76108747_10uM_6h,BRD-K76108747,10 uM,6 h,3,47,50,1,1,0,1,NEU
BRD-K93541117_10uM_24h,BRD-K93541117,10 uM,24 h,3,32,35,1,8,3,5,NEU
BRD-A98888159_10uM_24h,BRD-A98888159,10 uM,24 h,3,32,35,1,0,0,0,NEU
ketocholesterol_10uM_6h,ketocholesterol,10 uM,6 h,3,29,32,1,1,1,0,NEU
BRD-K82326223_10uM_6h,BRD-K82326223,10 uM,6 h,3,47,50,1,0,0,0,NEU
HDAC3-selective_10uM_6h,HDAC3-selective,10 uM,6 h,3,47,50,1,11,8,3,NEU
BRD-K89912164_10uM_24h,BRD-K89912164,10 uM,24 h,3,24,27,1,5,1,4,NEU
BRD-K19653414_10uM_6h,BRD-K19653414,10 uM,6 h,3,47,50,1,6,6,0,NEU
BRD-K61529775_10uM_24h,BRD-K61529775,10 uM,24 h,3,32,35,1,2,2,0,NEU
BG-1027_10uM_24h,BG-1027,10 uM,24 h,3,24,27,1,342,170,172,NEU
BRD-K20151898_10uM_6h,BRD-K20151898,10 uM,6 h,3,47,50,1,0,0,0,NEU
BRD-K83836748_10uM_24h,BRD-K83836748,10 uM,24 h,3,25,28,1,0,0,0,NEU
glibenclamide_10uM_24h,glibenclamide,10 uM,24 h,3,32,35,1,0,0,0,NEU
BRD-K22828860_10uM_24h,BRD-K22828860,10 uM,24 h,3,32,35,1,0,0,0,NEU
ST-013960_10uM_24h,ST-013960,10 uM,24 h,3,32,35,1,6,2,4,NEU
BRD-A09073503_10uM_24h,BRD-A09073503,10 uM,24 h,3,25,28,1,6,1,5,NEU
BML-266_10uM_24h,BML-266,10 uM,24 h,3,24,27,1,6,1,5,NEU
RAN-27_10uM_24h,RAN-27,10 uM,24 h,3,32,35,1,0,0,0,NEU
BRD-K63220166_10uM_24h,BRD-K63220166,10 uM,24 h,3,32,35,1,5,2,3,NEU
glutamyldopamine_10uM_6h,glutamyldopamine,10 uM,6 h,3,47,50,1,0,0,0,NEU
Val-Val-Val_10uM_6h,Val-Val-Val,10 uM,6 h,3,29,32,1,1,0,1,NEU
BRD-A74767450_10uM_24h,BRD-A74767450,10 uM,24 h,3,25,28,1,4,2,2,NEU
Fluoro-SAHA_10uM_24h,Fluoro-SAHA,10 uM,24 h,3,25,28,1,177,74,103,NEU
BRD-K75971499_10uM_6h,BRD-K75971499,10 uM,6 h,3,47,50,1,19,16,3,NEU
aminoresveratrol_10uM_24h,aminoresveratrol,10 uM,24 h,3,24,27,1,38,10,28,NEU
BRD-K30958640_10uM_24h,BRD-K30958640,10 uM,24 h,3,32,35,1,6,2,4,NEU
BRD-K84855052_10uM_24h,BRD-K84855052,10 uM,24 h,3,32,35,1,0,0,0,NEU
BRD-K15241725_10uM_24h,BRD-K15241725,10 uM,24 h,3,25,28,1,0,0,0,NEU
BRD-K59946561_10uM_6h,BRD-K59946561,10 uM,6 h,3,29,32,1,7,2,5,NEU
valproxam_10uM_6h,valproxam,10 uM,6 h,3,29,32,1,0,0,0,NEU
BG-1032_10uM_24h,BG-1032,10 uM,24 h,3,24,27,1,93,35,58,NEU
CAY-10470_10uM_24h,CAY-10470,10 uM,24 h,3,32,35,1,2,1,1,NEU
RAN-05_10uM_24h,RAN-05,10 uM,24 h,3,32,35,1,0,0,0,NEU
TMI-15_10uM_24h,TMI-15,10 uM,24 h,3,32,35,1,0,0,0,NEU
6-nitrodopamine_10uM_6h,6-nitrodopamine,10 uM,6 h,3,47,50,1,3,2,1,NEU
BRD-K96834847_10uM_6h,BRD-K96834847,10 uM,6 h,3,47,50,1,0,0,0,NEU
salermide_10uM_6h,salermide,10 uM,6 h,3,29,32,1,0,0,0,NEU
BRD-K36651625_10uM_24h,BRD-K36651625,10 uM,24 h,3,25,28,1,11,0,11,NEU
BRD-A32582647_10uM_24h,BRD-A32582647,10 uM,24 h,3,25,28,1,0,0,0,NEU
cardamonin_10uM_6h,cardamonin,10 uM,6 h,3,29,32,1,1,1,0,NEU
BRD-K84252391_10uM_6h,BRD-K84252391,10 uM,6 h,3,47,50,1,0,0,0,NEU
BRD-K76052538_10uM_24h,BRD-K76052538,10 uM,24 h,3,32,35,1,0,0,0,NEU
BRD-K39687892_10uM_24h,BRD-K39687892,10 uM,24 h,3,32,35,1,4,1,3,NEU
BRD-K96834847_10uM_24h,BRD-K96834847,10 uM,24 h,3,25,28,1,8,5,3,NEU
BRD-K05396879_10uM_6h,BRD-K05396879,10 uM,6 h,3,29,32,1,6,6,0,NEU
BRD-K00878439_10uM_24h,BRD-K00878439,10 uM,24 h,3,25,28,1,0,0,0,NEU
BG-1023_10uM_24h,BG-1023,10 uM,24 h,3,24,27,1,5,1,4,NEU
BRD-K61463582_10uM_6h,BRD-K61463582,10 uM,6 h,3,29,32,1,0,0,0,NEU
IWP-2_10uM_6h,IWP-2,10 uM,6 h,3,29,32,1,0,0,0,NEU
BRD-K24304282_10uM_6h,BRD-K24304282,10 uM,6 h,3,47,50,1,2,1,1,NEU
LBH-589_10uM_24h,LBH-589,10 uM,24 h,3,25,28,1,211,98,113,NEU
L-744832_10uM_24h,L-744832,10 uM,24 h,3,25,28,1,1,1,0,NEU
RTI-55_10uM_24h,RTI-55,10 uM,24 h,3,25,28,1,0,0,0,NEU
BRD-A06779035_10uM_24h,BRD-A06779035,10 uM,24 h,3,25,28,1,114,37,77,NEU
BRD-K76926998_10uM_24h,BRD-K76926998,10 uM,24 h,3,32,35,1,3,1,2,NEU
carbacyclin_10uM_6h,carbacyclin,10 uM,6 h,3,29,32,1,0,0,0,NEU
BRD-K33943862_10uM_24h,BRD-K33943862,10 uM,24 h,3,25,28,1,34,11,23,NEU
BRD-A92334183_10uM_6h,BRD-A92334183,10 uM,6 h,3,47,50,1,10,1,9,NEU
dichlorobenzamil_10uM_6h,dichlorobenzamil,10 uM,6 h,3,47,50,1,4,2,2,NEU
BRD-K74711637_10uM_24h,BRD-K74711637,10 uM,24 h,3,32,35,1,38,15,23,NEU
BRD-K56518176_10uM_24h,BRD-K56518176,10 uM,24 h,3,32,35,1,0,0,0,NEU
K784-3131_10uM_24h,K784-3131,10 uM,24 h,3,32,35,1,23,16,7,NEU
BRD-K95349679_10uM_24h,BRD-K95349679,10 uM,24 h,3,32,35,1,6,2,4,NEU
MW-A1-18_10uM_24h,MW-A1-18,10 uM,24 h,3,32,35,1,4,3,1,NEU
BRD-K70771662_10uM_24h,BRD-K70771662,10 uM,24 h,3,32,35,1,5,4,1,NEU
BRD-K38519699_10uM_24h,BRD-K38519699,10 uM,24 h,3,32,35,1,0,0,0,NEU
BRD-K35004659_10uM_24h,BRD-K35004659,10 uM,24 h,3,32,35,1,2,1,1,NEU
BRD-K88575585_10uM_24h,BRD-K88575585,10 uM,24 h,3,25,28,1,161,39,122,NEU
BRD-K47535255_10uM_24h,BRD-K47535255,10 uM,24 h,3,25,28,1,42,12,30,NEU
BRD-K75903201_10uM_24h,BRD-K75903201,10 uM,24 h,3,32,35,1,0,0,0,NEU
BRD-K31851742_10uM_24h,BRD-K31851742,10 uM,24 h,3,32,35,1,4,2,2,NEU
BRD-K40087974_10uM_24h,BRD-K40087974,10 uM,24 h,3,32,35,1,2,1,1,NEU
BRD-K35923252_10uM_24h,BRD-K35923252,10 uM,24 h,3,24,27,1,265,110,155,NEU
BRD-K23875128_10uM_24h,BRD-K23875128,10 uM,24 h,3,24,27,1,88,30,58,NEU
BML-210_10uM_6h,BML-210,10 uM,6 h,3,29,32,1,65,20,45,NEU
BRD-K97440753_10uM_24h,BRD-K97440753,10 uM,24 h,3,32,35,1,1,1,0,NEU
BRD-K33396764_10uM_24h,BRD-K33396764,10 uM,24 h,3,32,35,1,0,0,0,NEU
BRD-K87432599_10uM_24h,BRD-K87432599,10 uM,24 h,3,32,35,1,0,0,0,NEU
BRD-K73418978_10uM_24h,BRD-K73418978,10 uM,24 h,3,32,35,1,0,0,0,NEU
BRD-K91614993_10uM_24h,BRD-K91614993,10 uM,24 h,3,25,28,1,2,0,2,NEU
BRD-M25555076_10uM_24h,BRD-M25555076,10 uM,24 h,3,25,28,1,0,0,0,NEU
BRD-A14999564_10uM_6h,BRD-A14999564,10 uM,6 h,3,47,50,1,4,1,3,NEU
BRD-K70960308_10uM_24h,BRD-K70960308,10 uM,24 h,3,32,35,1,1,1,0,NEU
BRD-K97631938_10uM_24h,BRD-K97631938,10 uM,24 h,3,32,35,1,6,4,2,NEU
bietaserpine_10uM_6h,bietaserpine,10 uM,6 h,3,47,50,1,1,1,0,NEU
SR-147778_10uM_24h,SR-147778,10 uM,24 h,3,25,28,1,5,1,4,NEU
BRD-A42610307_10uM_6h,BRD-A42610307,10 uM,6 h,3,47,50,1,43,28,15,NEU
BRD-A55317422_10uM_24h,BRD-A55317422,10 uM,24 h,3,25,28,1,202,43,159,NEU
BRD-K13195996_10uM_24h,BRD-K13195996,10 uM,24 h,3,25,28,1,0,0,0,NEU
BRD-A89208012_10uM_24h,BRD-A89208012,10 uM,24 h,3,32,35,1,8,5,3,NEU
BRD-A09053961_10uM_6h,BRD-A09053961,10 uM,6 h,3,47,50,1,0,0,0,NEU
isonicotinohydroxamic-acid_10uM_6h,isonicotinohydroxamic-acid,10 uM,6 h,3,29,32,1,0,0,0,NEU
BRD-A84389633_10uM_24h,BRD-A84389633,10 uM,24 h,3,32,35,1,4,3,1,NEU
GR-89696_10uM_24h,GR-89696,10 uM,24 h,3,32,35,1,0,0,0,NEU
BRD-A06131576_10uM_24h,BRD-A06131576,10 uM,24 h,3,32,35,1,6,3,3,NEU
BRD-K63175663_10uM_24h,BRD-K63175663,10 uM,24 h,3,32,35,1,2,1,1,NEU
TC-2559_10uM_24h,TC-2559,10 uM,24 h,3,32,35,1,2,1,1,NEU
BRD-K44890999_10uM_24h,BRD-K44890999,10 uM,24 h,3,32,35,1,0,0,0,NEU
chrysamine-g_10uM_6h,chrysamine-g,10 uM,6 h,3,47,50,1,0,0,0,NEU
cyclosporin-a_10uM_24h,cyclosporin-a,10 uM,24 h,3,32,35,1,0,0,0,NEU
harmine_10uM_6h,harmine,10 uM,6 h,3,29,32,1,0,0,0,NEU
flavanone_10uM_24h,flavanone,10 uM,24 h,3,24,27,1,24,16,8,NEU
carbacyclin_10uM_24h,carbacyclin,10 uM,24 h,3,24,27,1,10,5,5,NEU
BRD-K91614993_10uM_6h,BRD-K91614993,10 uM,6 h,3,47,50,1,3,2,1,NEU
BRD-K69003436_10uM_24h,BRD-K69003436,10 uM,24 h,3,32,35,1,0,0,0,NEU
BRD-K27881911_10uM_24h,BRD-K27881911,10 uM,24 h,3,32,35,1,0,0,0,NEU
BRD-K93760529_10uM_24h,BRD-K93760529,10 uM,24 h,3,32,35,1,4,0,4,NEU
graveoline_10uM_24h,graveoline,10 uM,24 h,3,32,35,1,1,1,0,NEU
BG-1021_10uM_24h,BG-1021,10 uM,24 h,3,24,27,1,59,23,36,NEU
BRD-A81472640_10uM_6h,BRD-A81472640,10 uM,6 h,3,47,50,1,0,0,0,NEU
BG-1031_10uM_24h,BG-1031,10 uM,24 h,3,24,27,1,4,0,4,NEU
BRD-K31460632_10uM_6h,BRD-K31460632,10 uM,6 h,3,47,50,1,1,0,1,NEU
BG-1005_10uM_6h,BG-1005,10 uM,6 h,3,29,32,1,177,114,63,NEU
BRD-A00763758_10uM_6h,BRD-A00763758,10 uM,6 h,3,47,50,1,2,1,1,NEU
BRD-K43014159_10uM_6h,BRD-K43014159,10 uM,6 h,3,47,50,1,2,0,2,NEU
eicosatetraynoic-acid_10uM_6h,eicosatetraynoic-acid,10 uM,6 h,3,29,32,1,7,3,4,NEU
MC-1293_10uM_24h,MC-1293,10 uM,24 h,3,24,27,1,0,0,0,NEU
BG-1004_10uM_6h,BG-1004,10 uM,6 h,3,47,50,1,115,81,34,NEU
rottlerin_10uM_24h,rottlerin,10 uM,24 h,3,24,27,1,247,86,161,NEU
BRD-K56621596_10uM_24h,BRD-K56621596,10 uM,24 h,3,25,28,1,0,0,0,NEU
KDM-096_10uM_6h,KDM-096,10 uM,6 h,3,47,50,1,2,0,2,NEU
BRD-K36162096_10uM_6h,BRD-K36162096,10 uM,6 h,3,29,32,1,0,0,0,NEU
BRD-K82206012_10uM_6h,BRD-K82206012,10 uM,6 h,3,29,32,1,0,0,0,NEU
ISOX_10uM_24h,ISOX,10 uM,24 h,3,24,27,1,327,138,189,NEU
BRD-K63116520_10uM_6h,BRD-K63116520,10 uM,6 h,3,47,50,1,2,1,1,NEU
isonicotinamide_10uM_6h,isonicotinamide,10 uM,6 h,3,29,32,1,0,0,0,NEU
BRD-K04722205_10uM_24h,BRD-K04722205,10 uM,24 h,3,24,27,1,34,7,27,NEU
BRD-K36031023_10uM_24h,BRD-K36031023,10 uM,24 h,3,32,35,1,1,0,1,NEU
SKF-83822_10uM_24h,SKF-83822,10 uM,24 h,3,25,28,1,73,15,58,NEU
BRD-K23628492_10uM_24h,BRD-K23628492,10 uM,24 h,3,25,28,1,0,0,0,NEU
BRD-K00551481_10uM_24h,BRD-K00551481,10 uM,24 h,3,32,35,1,4,3,1,NEU
BRD-A82913781_10uM_24h,BRD-A82913781,10 uM,24 h,3,32,35,1,0,0,0,NEU
MD-041_10uM_24h,MD-041,10 uM,24 h,3,32,35,1,0,0,0,NEU
BRD-K28308851_10uM_6h,BRD-K28308851,10 uM,6 h,3,47,50,1,7,5,2,NEU
BRD-A04332542_10uM_24h,BRD-A04332542,10 uM,24 h,3,25,28,1,101,32,69,NEU
BRD-U85918428_10uM_24h,BRD-U85918428,10 uM,24 h,3,25,28,1,0,0,0,NEU
BRD-A35153197_10uM_6h,BRD-A35153197,10 uM,6 h,3,47,50,1,1,0,1,NEU
BRD-A14795281_10uM_24h,BRD-A14795281,10 uM,24 h,3,25,28,1,4,2,2,NEU
BG-1011_10uM_6h,BG-1011,10 uM,6 h,3,29,32,1,2,2,0,NEU
GGTI-297_10uM_24h,GGTI-297,10 uM,24 h,3,25,28,1,47,10,37,NEU
BRD-A26347577_10uM_24h,BRD-A26347577,10 uM,24 h,3,25,28,1,0,0,0,NEU
BRD-A17081056_10uM_6h,BRD-A17081056,10 uM,6 h,3,47,50,1,2,2,0,NEU
BRD-A29119732_10uM_24h,BRD-A29119732,10 uM,24 h,3,25,28,1,247,68,179,NEU
BG-1016_10uM_6h,BG-1016,10 uM,6 h,3,29,32,1,6,2,4,NEU
BRD-K10283649_10uM_6h,BRD-K10283649,10 uM,6 h,3,47,50,1,2,2,0,NEU
BRD-K77014406_10uM_24h,BRD-K77014406,10 uM,24 h,3,32,35,1,1,0,1,NEU
BG-1012_10uM_6h,BG-1012,10 uM,6 h,3,29,32,1,0,0,0,NEU
BML-286_10uM_24h,BML-286,10 uM,24 h,3,24,27,1,12,1,11,NEU
BRD-K65213718_10uM_24h,BRD-K65213718,10 uM,24 h,3,25,28,1,1,1,0,NEU
BG-1026_10uM_6h,BG-1026,10 uM,6 h,3,29,32,1,136,90,46,NEU
BRD-K61260019_10uM_24h,BRD-K61260019,10 uM,24 h,3,25,28,1,191,67,124,NEU
BRD-K27332342_10uM_24h,BRD-K27332342,10 uM,24 h,3,24,27,1,0,0,0,NEU
BRD-A65771317_10uM_24h,BRD-A65771317,10 uM,24 h,3,25,28,1,119,57,62,NEU
BRD-K13629382_10uM_6h,BRD-K13629382,10 uM,6 h,3,47,50,1,97,62,35,NEU
methyltyramine_10uM_6h,methyltyramine,10 uM,6 h,3,47,50,1,0,0,0,NEU
BG-1007_10uM_6h,BG-1007,10 uM,6 h,3,29,32,1,104,56,48,NEU
BRD-K81313552_10uM_24h,BRD-K81313552,10 uM,24 h,3,32,35,1,0,0,0,NEU
BRD-K56596360_10uM_24h,BRD-K56596360,10 uM,24 h,3,32,35,1,7,1,6,NEU
BRD-A36884011_10uM_24h,BRD-A36884011,10 uM,24 h,3,32,35,1,21,10,11,NEU
BRD-K84114569_10uM_24h,BRD-K84114569,10 uM,24 h,3,32,35,1,0,0,0,NEU
androstenedione_10uM_6h,androstenedione,10 uM,6 h,3,29,32,1,0,0,0,NEU
BRD-K37846922_10uM_6h,BRD-K37846922,10 uM,6 h,3,29,32,1,1,0,1,NEU
BRD-K19042873_10uM_24h,BRD-K19042873,10 uM,24 h,3,25,28,1,156,41,115,NEU
BG-1032_10uM_6h,BG-1032,10 uM,6 h,3,29,32,1,7,1,6,NEU
BRD-A00763758_10uM_24h,BRD-A00763758,10 uM,24 h,3,25,28,1,3,0,3,NEU
BRD-K78787248_10uM_6h,BRD-K78787248,10 uM,6 h,3,47,50,1,0,0,0,NEU
BRD-K76941385_10uM_24h,BRD-K76941385,10 uM,24 h,3,25,28,1,0,0,0,NEU
BRD-K69458799_10uM_6h,BRD-K69458799,10 uM,6 h,3,47,50,1,0,0,0,NEU
TER-14687_10uM_24h,TER-14687,10 uM,24 h,3,32,35,1,4,4,0,NEU
BRD-K99636700_10uM_24h,BRD-K99636700,10 uM,24 h,3,24,27,1,405,150,255,NEU
ML-4054_10uM_24h,ML-4054,10 uM,24 h,3,32,35,1,0,0,0,NEU
JFD02227_10uM_24h,JFD02227,10 uM,24 h,3,32,35,1,2,0,2,NEU
XMD-1499_10uM_24h,XMD-1499,10 uM,24 h,3,65,68,1,11,6,5,NEU
malonoben_10uM_24h,malonoben,10 uM,24 h,3,32,35,1,41,8,33,NEU
BRD-A26347577_10uM_6h,BRD-A26347577,10 uM,6 h,3,47,50,1,0,0,0,NEU
BG-1030_10uM_24h,BG-1030,10 uM,24 h,3,24,27,1,381,193,188,NEU
W-7_10uM_24h,W-7,10 uM,24 h,3,25,28,1,0,0,0,NEU
BAY-59-3074_10uM_24h,BAY-59-3074,10 uM,24 h,3,32,35,1,1,1,0,NEU
EMD-41000_10uM_24h,EMD-41000,10 uM,24 h,3,32,35,1,0,0,0,NEU
LY-165163_10uM_24h,LY-165163,10 uM,24 h,3,25,28,1,4,4,0,NEU
garcinol_10uM_6h,garcinol,10 uM,6 h,3,29,32,1,0,0,0,NEU
BRD-K86940927_10uM_24h,BRD-K86940927,10 uM,24 h,3,25,28,1,297,84,213,NEU
BRD-A88029023_10uM_24h,BRD-A88029023,10 uM,24 h,3,32,35,1,1,1,0,NEU
SKF-83822_10uM_6h,SKF-83822,10 uM,6 h,3,47,50,1,1,0,1,NEU
niguldipine_10uM_6h,niguldipine,10 uM,6 h,3,29,32,1,7,7,0,NEU
Fluoro-SAHA_10uM_6h,Fluoro-SAHA,10 uM,6 h,3,47,50,1,141,109,32,NEU
BRD-K88708949_10uM_24h,BRD-K88708949,10 uM,24 h,3,32,35,1,10,4,6,NEU
BRD-K85123403_10uM_24h,BRD-K85123403,10 uM,24 h,3,32,35,1,11,5,6,NEU
WT-171_10uM_24h,WT-171,10 uM,24 h,3,32,35,1,46,16,30,NEU
RAN-30_10uM_24h,RAN-30,10 uM,24 h,3,32,35,1,0,0,0,NEU
BG-1002_10uM_6h,BG-1002,10 uM,6 h,3,47,50,1,0,0,0,NEU
BG-1017_10uM_6h,BG-1017,10 uM,6 h,3,29,32,1,15,9,6,NEU
BRD-K10283649_10uM_24h,BRD-K10283649,10 uM,24 h,3,25,28,1,1,1,0,NEU
SR-144528_10uM_6h,SR-144528,10 uM,6 h,3,47,50,1,0,0,0,NEU
BRD-K23986500_10uM_24h,BRD-K23986500,10 uM,24 h,3,25,28,1,6,4,2,NEU
AG-592_10uM_24h,AG-592,10 uM,24 h,3,32,35,1,2,2,0,NEU
BG-1013_10uM_6h,BG-1013,10 uM,6 h,3,29,32,1,0,0,0,NEU
HO-013_10uM_24h,HO-013,10 uM,24 h,3,28,31,2,0,0,0,NEU
flumetasone_10uM_24h,flumetasone,10 uM,24 h,3,32,35,1,0,0,0,NEU
usnic-acid_10uM_6h,usnic-acid,10 uM,6 h,3,29,32,1,0,0,0,NEU
BIX-01338_10uM_24h,BIX-01338,10 uM,24 h,3,32,35,1,0,0,0,NEU
MW-A1-14_10uM_24h,MW-A1-14,10 uM,24 h,3,32,35,1,5,1,4,NEU
BRD-K29983336_10uM_24h,BRD-K29983336,10 uM,24 h,3,65,68,1,0,0,0,NEU
BG-1002_10uM_24h,BG-1002,10 uM,24 h,3,25,28,1,104,36,68,NEU
SR-48692_10uM_6h,SR-48692,10 uM,6 h,3,47,50,1,0,0,0,NEU
SKF-82958_10uM_24h,SKF-82958,10 uM,24 h,3,25,28,1,1,0,1,NEU
BRD-K04923131_10uM_6h,BRD-K04923131,10 uM,6 h,3,29,32,1,28,18,10,NEU
BRD-K86940927_10uM_6h,BRD-K86940927,10 uM,6 h,3,47,50,1,6,4,2,NEU
ST-4039884_10uM_24h,ST-4039884,10 uM,24 h,3,32,35,1,1,1,0,NEU
BRD-K72783841_10uM_24h,BRD-K72783841,10 uM,24 h,3,32,35,1,0,0,0,NEU
BRD-A51916548_10uM_24h,BRD-A51916548,10 uM,24 h,3,25,28,1,0,0,0,NEU
W-5_10uM_6h,W-5,10 uM,6 h,3,47,50,1,0,0,0,NEU
BRD-K35923252_10uM_6h,BRD-K35923252,10 uM,6 h,3,29,32,1,17,14,3,NEU
BRD-K00859168_10uM_24h,BRD-K00859168,10 uM,24 h,3,32,35,1,0,0,0,NEU
BRD-K08713111_10uM_6h,BRD-K08713111,10 uM,6 h,3,47,50,1,5,3,2,NEU
BRD-K92326486_10uM_24h,BRD-K92326486,10 uM,24 h,3,25,28,1,0,0,0,NEU
BRD-K38756014_10uM_6h,BRD-K38756014,10 uM,6 h,3,29,32,1,0,0,0,NEU
L-744832_10uM_6h,L-744832,10 uM,6 h,3,47,50,1,2,2,0,NEU
BRD-K98991361_10uM_24h,BRD-K98991361,10 uM,24 h,3,32,35,1,0,0,0,NEU
RTI-55_10uM_6h,RTI-55,10 uM,6 h,3,47,50,1,4,2,2,NEU
BRD-K40367460_10uM_24h,BRD-K40367460,10 uM,24 h,3,25,28,1,0,0,0,NEU
BRD-A76732176_10uM_24h,BRD-A76732176,10 uM,24 h,3,32,35,1,0,0,0,NEU
BG-1009_10uM_24h,BG-1009,10 uM,24 h,3,24,27,1,27,17,10,NEU
BRD-A61866602_10uM_6h,BRD-A61866602,10 uM,6 h,3,47,50,1,3,1,2,NEU
UGISS-186_10uM_24h,UGISS-186,10 uM,24 h,3,32,35,1,0,0,0,NEU
BRD-K05542495_10uM_24h,BRD-K05542495,10 uM,24 h,3,32,35,1,6,4,2,NEU
BRD-K47503321_10uM_6h,BRD-K47503321,10 uM,6 h,3,29,32,1,6,2,4,NEU
BRD-K56621596_10uM_6h,BRD-K56621596,10 uM,6 h,3,47,50,1,2,0,2,NEU
BOX-5_10uM_6h,BOX-5,10 uM,6 h,3,29,32,1,0,0,0,NEU
penitrem-a_10uM_6h,penitrem-a,10 uM,6 h,3,29,32,1,28,23,5,NEU
MD-II-051_10uM_24h,MD-II-051,10 uM,24 h,3,32,35,1,2,0,2,NEU
BRD-K90090262_10uM_24h,BRD-K90090262,10 uM,24 h,3,32,35,1,1,0,1,NEU
BRD-K76425827_10uM_24h,BRD-K76425827,10 uM,24 h,3,32,35,1,1,0,1,NEU
SGX-523_10uM_24h,SGX-523,10 uM,24 h,3,65,68,1,3,3,0,NEU
BRD-K09887211_10uM_24h,BRD-K09887211,10 uM,24 h,3,25,28,1,5,0,5,NEU
BRD-K36162096_10uM_24h,BRD-K36162096,10 uM,24 h,3,24,27,1,0,0,0,NEU
salsolinol_10uM_24h,salsolinol,10 uM,24 h,3,25,28,1,0,0,0,NEU
BRD-A06779035_10uM_6h,BRD-A06779035,10 uM,6 h,3,47,50,1,0,0,0,NEU
BRD-K55332332_10uM_24h,BRD-K55332332,10 uM,24 h,3,25,28,1,1,0,1,NEU
BRD-K91485395_10uM_24h,BRD-K91485395,10 uM,24 h,3,32,35,1,7,3,4,NEU
BRD-K73155123_10uM_24h,BRD-K73155123,10 uM,24 h,3,32,35,1,0,0,0,NEU
BRD-A68802837_10uM_24h,BRD-A68802837,10 uM,24 h,3,25,28,1,26,3,23,NEU
propanoic-acid_10uM_6h,propanoic-acid,10 uM,6 h,3,47,50,1,0,0,0,NEU
BRD-K24307074_10uM_24h,BRD-K24307074,10 uM,24 h,3,25,28,1,60,20,40,NEU
BRD-K25774147_10uM_24h,BRD-K25774147,10 uM,24 h,3,32,35,1,1,1,0,NEU
GR-55562_10uM_24h,GR-55562,10 uM,24 h,3,32,35,1,0,0,0,NEU
purpurogallin_10uM_6h,purpurogallin,10 uM,6 h,3,29,32,1,4,1,3,NEU
BRD-K41049123_10uM_6h,BRD-K41049123,10 uM,6 h,3,47,50,1,2,2,0,NEU
BRD-U65466710_10uM_24h,BRD-U65466710,10 uM,24 h,3,25,28,1,1,0,1,NEU
JMV-431_10uM_6h,JMV-431,10 uM,6 h,3,47,50,1,4,4,0,NEU
BRD-K97591839_10uM_24h,BRD-K97591839,10 uM,24 h,3,25,28,1,0,0,0,NEU
gingerol_10uM_24h,gingerol,10 uM,24 h,3,24,27,1,0,0,0,NEU
BRD-K74773935_10uM_6h,BRD-K74773935,10 uM,6 h,3,47,50,1,2,1,1,NEU
SK-383933_10uM_24h,SK-383933,10 uM,24 h,3,25,28,1,32,14,18,NEU
6-nitronorepinephrine_10uM_6h,6-nitronorepinephrine,10 uM,6 h,3,47,50,1,3,2,1,NEU
hippeastrine_10uM_24h,hippeastrine,10 uM,24 h,3,32,35,1,0,0,0,NEU
BRD-K30381304_10uM_24h,BRD-K30381304,10 uM,24 h,3,32,35,1,0,0,0,NEU
BRD-K50368246_10uM_24h,BRD-K50368246,10 uM,24 h,3,32,35,1,2,0,2,NEU
carnosol_10uM_6h,carnosol,10 uM,6 h,3,29,32,1,2,2,0,NEU
BRD-A76934284_10uM_6h,BRD-A76934284,10 uM,6 h,3,47,50,1,2,0,2,NEU
BRD-A65140285_10uM_6h,BRD-A65140285,10 uM,6 h,3,47,50,1,3,3,0,NEU
BRD-K07653295_10uM_6h,BRD-K07653295,10 uM,6 h,3,47,50,1,6,5,1,NEU
BML-266_10uM_6h,BML-266,10 uM,6 h,3,29,32,1,5,0,5,NEU
BRD-A41986761_10uM_6h,BRD-A41986761,10 uM,6 h,3,47,50,1,0,0,0,NEU
BRD-K65050353_10uM_24h,BRD-K65050353,10 uM,24 h,3,32,35,1,0,0,0,NEU
BRD-A66861218_10uM_24h,BRD-A66861218,10 uM,24 h,3,32,35,1,3,3,0,NEU
TUL-XXI039_10uM_24h,TUL-XXI039,10 uM,24 h,3,32,35,1,0,0,0,NEU
BRD-K18722736_10uM_6h,BRD-K18722736,10 uM,6 h,3,47,50,1,97,45,52,NEU
BRD-A40163033_10uM_6h,BRD-A40163033,10 uM,6 h,3,47,50,1,1,0,1,NEU
BRD-A24951056_10uM_24h,BRD-A24951056,10 uM,24 h,3,25,28,1,3,0,3,NEU
BRD-K35568648_10uM_24h,BRD-K35568648,10 uM,24 h,3,32,35,1,9,3,6,NEU
BRD-U61360806_10uM_24h,BRD-U61360806,10 uM,24 h,3,24,27,1,42,19,23,NEU
ionomycin_10uM_6h,ionomycin,10 uM,6 h,3,29,32,1,87,32,55,NEU
BRD-K35307346_10uM_24h,BRD-K35307346,10 uM,24 h,3,24,27,1,11,1,10,NEU
BRD-M91737268_10uM_24h,BRD-M91737268,10 uM,24 h,3,25,28,1,2,2,0,NEU
NCH-51_10uM_6h,NCH-51,10 uM,6 h,3,29,32,1,131,66,65,NEU
RAN-03_10uM_24h,RAN-03,10 uM,24 h,3,32,35,1,18,4,14,NEU
fillalbin_10uM_24h,fillalbin,10 uM,24 h,3,32,35,1,11,5,6,NEU
JNK-IN-5A_10uM_24h,JNK-IN-5A,10 uM,24 h,3,65,68,1,9,7,2,NEU
BRD-K58930050_10uM_6h,BRD-K58930050,10 uM,6 h,3,47,50,1,8,5,3,NEU
CCT036477_10uM_6h,CCT036477,10 uM,6 h,3,29,32,1,139,87,52,NEU
BRD-K69888333_10uM_24h,BRD-K69888333,10 uM,24 h,3,32,35,1,37,12,25,NEU
BL-077_10uM_6h,BL-077,10 uM,6 h,3,29,32,1,0,0,0,NEU
BG-1014_10uM_6h,BG-1014,10 uM,6 h,3,29,32,1,5,5,0,NEU
BRD-K79052598_10uM_6h,BRD-K79052598,10 uM,6 h,3,47,50,1,1,1,0,NEU
n-methylphenothiazine_10uM_24h,n-methylphenothiazine,10 uM,24 h,3,25,28,1,0,0,0,NEU
BRD-K92073408_10uM_24h,BRD-K92073408,10 uM,24 h,3,32,35,1,2,1,1,NEU
BRD-K71574320_10uM_24h,BRD-K71574320,10 uM,24 h,3,32,35,1,10,3,7,NEU
BRD-K67582595_10uM_6h,BRD-K67582595,10 uM,6 h,3,47,50,1,0,0,0,NEU
allantoxanamide_10uM_6h,allantoxanamide,10 uM,6 h,3,47,50,1,0,0,0,NEU
BRD-K99667445_10uM_6h,BRD-K99667445,10 uM,6 h,3,29,32,1,4,0,4,NEU
BRD-K71935468_10uM_24h,BRD-K71935468,10 uM,24 h,3,32,35,1,2,1,1,NEU
BRD-K04188046_10uM_24h,BRD-K04188046,10 uM,24 h,3,32,35,1,1,1,0,NEU
BRD-K04877770_10uM_6h,BRD-K04877770,10 uM,6 h,3,47,50,1,2,2,0,NEU
BRD-A26333730_10uM_24h,BRD-A26333730,10 uM,24 h,3,25,28,1,0,0,0,NEU
leoidin_10uM_24h,leoidin,10 uM,24 h,3,32,35,1,0,0,0,NEU
LY-288513_10uM_24h,LY-288513,10 uM,24 h,3,32,35,1,0,0,0,NEU
BRD-K58972465_10uM_24h,BRD-K58972465,10 uM,24 h,3,32,35,1,0,0,0,NEU
LY-165163_10uM_6h,LY-165163,10 uM,6 h,3,47,50,1,2,0,2,NEU
TUL-XX025TFA_10uM_24h,TUL-XX025TFA,10 uM,24 h,3,32,35,1,0,0,0,NEU
BRD-K38205437_10uM_24h,BRD-K38205437,10 uM,24 h,3,32,35,1,0,0,0,NEU
BRD-K88741031_10uM_24h,BRD-K88741031,10 uM,24 h,3,32,35,1,6,4,2,NEU
BRD-A27640568_10uM_24h,BRD-A27640568,10 uM,24 h,3,32,35,1,0,0,0,NEU
BRD-K81813927_10uM_24h,BRD-K81813927,10 uM,24 h,3,32,35,1,0,0,0,NEU
coumestrol_10uM_24h,coumestrol,10 uM,24 h,3,32,35,1,1,0,1,NEU
BRD-A55317422_10uM_6h,BRD-A55317422,10 uM,6 h,3,47,50,1,0,0,0,NEU
BRD-K20985754_10uM_24h,BRD-K20985754,10 uM,24 h,3,25,28,1,0,0,0,NEU
BRD-K82326223_10uM_24h,BRD-K82326223,10 uM,24 h,3,25,28,1,0,0,0,NEU
PMSF_10uM_24h,PMSF,10 uM,24 h,3,24,27,1,1,0,1,NEU
BG-1003_10uM_6h,BG-1003,10 uM,6 h,3,47,50,1,141,88,53,NEU
BG-1021_10uM_6h,BG-1021,10 uM,6 h,3,29,32,1,0,0,0,NEU
BRD-A82323890_10uM_24h,BRD-A82323890,10 uM,24 h,3,25,28,1,3,1,2,NEU
BRD-K56392985_10uM_24h,BRD-K56392985,10 uM,24 h,3,32,35,1,2,1,1,NEU
KDM-096_10uM_24h,KDM-096,10 uM,24 h,3,25,28,1,243,73,170,NEU
EMF-sumo1-7_10uM_24h,EMF-sumo1-7,10 uM,24 h,3,20,23,1,0,0,0,NEU
ALW-II-49-7_10uM_24h,ALW-II-49-7,10 uM,24 h,3,37,40,2,2,1,1,NEU
BRD-K98336812_10uM_24h,BRD-K98336812,10 uM,24 h,3,25,28,1,0,0,0,NEU
BG-1007_10uM_24h,BG-1007,10 uM,24 h,3,24,27,1,354,167,187,NEU
MC-1293_10uM_6h,MC-1293,10 uM,6 h,3,29,32,1,1,1,0,NEU
ecopipam_10uM_24h,ecopipam,10 uM,24 h,3,32,35,1,0,0,0,NEU
BRD-K98896788_10uM_24h,BRD-K98896788,10 uM,24 h,3,32,35,1,0,0,0,NEU
BRD-A09073503_10uM_6h,BRD-A09073503,10 uM,6 h,3,47,50,1,0,0,0,NEU
BRD-K45845523_10uM_6h,BRD-K45845523,10 uM,6 h,3,47,50,1,5,3,2,NEU
MW-STK33-4C_10uM_24h,MW-STK33-4C,10 uM,24 h,3,32,35,1,0,0,0,NEU
BRD-K14842454_10uM_24h,BRD-K14842454,10 uM,24 h,3,32,35,1,0,0,0,NEU
BRD-K12482929_10uM_24h,BRD-K12482929,10 uM,24 h,3,25,28,1,0,0,0,NEU
BG-1024_10uM_24h,BG-1024,10 uM,24 h,3,24,27,1,200,79,121,NEU
thapsigargin_10uM_24h,thapsigargin,10 uM,24 h,3,24,27,1,248,118,130,NEU
BRD-K19624190_10uM_24h,BRD-K19624190,10 uM,24 h,3,32,35,1,1,0,1,NEU
BRD-K54729176_10uM_6h,BRD-K54729176,10 uM,6 h,3,29,32,1,29,12,17,NEU
BRD-A81472640_10uM_24h,BRD-A81472640,10 uM,24 h,3,25,28,1,119,32,87,NEU
BRD-K21005091_10uM_24h,BRD-K21005091,10 uM,24 h,3,32,35,1,62,27,35,NEU
BRD-K30640165_10uM_24h,BRD-K30640165,10 uM,24 h,3,32,35,1,0,0,0,NEU
BRD-K96326565_10uM_24h,BRD-K96326565,10 uM,24 h,3,32,35,1,2,0,2,NEU
I-303059_10uM_24h,I-303059,10 uM,24 h,3,32,35,1,0,0,0,NEU
PD-149163_10uM_6h,PD-149163,10 uM,6 h,3,47,50,1,1,1,0,NEU
BRD-K09997269_10uM_24h,BRD-K09997269,10 uM,24 h,3,32,35,1,0,0,0,NEU
BRD-K81647657_10uM_24h,BRD-K81647657,10 uM,24 h,3,24,27,1,5,2,3,NEU
BRD-K07223205_10uM_6h,BRD-K07223205,10 uM,6 h,3,47,50,1,3,3,0,NEU
DAPT-GSI-IX_10uM_24h,DAPT-GSI-IX,10 uM,24 h,3,32,35,1,0,0,0,NEU
BRD-K95847244_10uM_24h,BRD-K95847244,10 uM,24 h,3,25,28,1,2,1,1,NEU
tyramine_10uM_6h,tyramine,10 uM,6 h,3,47,50,1,0,0,0,NEU
n-bromoacetyltryptamine_10uM_6h,n-bromoacetyltryptamine,10 uM,6 h,3,47,50,1,85,62,23,NEU
BRD-K31168993_10uM_6h,BRD-K31168993,10 uM,6 h,3,47,50,1,7,3,4,NEU
BRD-K29003210_10uM_24h,BRD-K29003210,10 uM,24 h,3,32,35,1,0,0,0,NEU
BRD-K01192156_10uM_24h,BRD-K01192156,10 uM,24 h,3,24,27,1,0,0,0,NEU
BRD-A69454249_10uM_24h,BRD-A69454249,10 uM,24 h,3,25,28,1,0,0,0,NEU
lithium-chloride_10uM_6h,lithium-chloride,10 uM,6 h,3,29,32,1,1,0,1,NEU
pseudoephedrine_10uM_24h,pseudoephedrine,10 uM,24 h,3,32,35,1,0,0,0,NEU
beta-alanine_10uM_24h,beta-alanine,10 uM,24 h,3,25,28,1,0,0,0,NEU
BRD-K87166736_10uM_6h,BRD-K87166736,10 uM,6 h,3,47,50,1,0,0,0,NEU
BRD-K44893543_10uM_24h,BRD-K44893543,10 uM,24 h,3,32,35,1,32,16,16,NEU
BRD-K49807497_10uM_24h,BRD-K49807497,10 uM,24 h,3,32,35,1,4,2,2,NEU
BRD-A13367427_10uM_24h,BRD-A13367427,10 uM,24 h,3,32,35,1,1,0,1,NEU
BRD-A35825362_10uM_6h,BRD-A35825362,10 uM,6 h,3,47,50,1,1,1,0,NEU
SIB-1508Y_10uM_6h,SIB-1508Y,10 uM,6 h,3,47,50,1,2,1,1,NEU
BRD-K83161876_10uM_24h,BRD-K83161876,10 uM,24 h,3,25,28,1,0,0,0,NEU
AS-605240_10uM_24h,AS-605240,10 uM,24 h,3,24,27,1,49,11,38,NEU
BRD-K73238422_10uM_24h,BRD-K73238422,10 uM,24 h,3,32,35,1,23,16,7,NEU
BAY-36-7620_10uM_6h,BAY-36-7620,10 uM,6 h,3,47,50,1,1,1,0,NEU
BRD-A26333730_10uM_6h,BRD-A26333730,10 uM,6 h,3,47,50,1,0,0,0,NEU
BRD-K87166736_10uM_24h,BRD-K87166736,10 uM,24 h,3,25,28,1,0,0,0,NEU
BRD-K31344914_10uM_24h,BRD-K31344914,10 uM,24 h,3,25,28,1,6,3,3,NEU
BRD-K44494044_10uM_24h,BRD-K44494044,10 uM,24 h,3,32,35,1,9,6,3,NEU
BRD-K65981456_10uM_6h,BRD-K65981456,10 uM,6 h,3,47,50,1,0,0,0,NEU
BRD-K61260019_10uM_6h,BRD-K61260019,10 uM,6 h,3,47,50,1,1,1,0,NEU
dipropyl-5ct_10uM_24h,dipropyl-5ct,10 uM,24 h,3,32,35,1,2,1,1,NEU
BRD-K97118047_10uM_24h,BRD-K97118047,10 uM,24 h,3,32,35,1,0,0,0,NEU
ST-003833_10uM_24h,ST-003833,10 uM,24 h,3,32,35,1,0,0,0,NEU
WAY-262611_10uM_6h,WAY-262611,10 uM,6 h,3,29,32,1,14,11,3,NEU
BRD-K41824522_10uM_6h,BRD-K41824522,10 uM,6 h,3,47,50,1,1,1,0,NEU
BRD-K97808269_10uM_24h,BRD-K97808269,10 uM,24 h,3,24,27,1,218,94,124,NEU
BRD-K89912164_10uM_6h,BRD-K89912164,10 uM,6 h,3,29,32,1,0,0,0,NEU
hydroxytyrosol_10uM_24h,hydroxytyrosol,10 uM,24 h,3,25,28,1,0,0,0,NEU
IDAM_10uM_6h,IDAM,10 uM,6 h,3,47,50,1,2,2,0,NEU
BRD-K25375605_10uM_24h,BRD-K25375605,10 uM,24 h,3,32,35,1,0,0,0,NEU
BRD-K39981244_10uM_24h,BRD-K39981244,10 uM,24 h,3,25,28,1,0,0,0,NEU
BRD-K14316227_10uM_24h,BRD-K14316227,10 uM,24 h,3,32,35,1,4,3,1,NEU
BRD-K18436203_10uM_6h,BRD-K18436203,10 uM,6 h,3,47,50,1,1,1,0,NEU
rotenone_10uM_6h,rotenone,10 uM,6 h,3,29,32,1,1,0,1,NEU
BRD-K94158209_10uM_6h,BRD-K94158209,10 uM,6 h,3,47,50,1,0,0,0,NEU
AG-494_10uM_24h,AG-494,10 uM,24 h,3,32,35,1,0,0,0,NEU
BRD-K49889622_10uM_6h,BRD-K49889622,10 uM,6 h,3,47,50,1,0,0,0,NEU
BRD-K36767861_10uM_24h,BRD-K36767861,10 uM,24 h,3,32,35,1,2,2,0,NEU
BRD-K23986500_10uM_6h,BRD-K23986500,10 uM,6 h,3,47,50,1,3,2,1,NEU
BRD-A84423900_10uM_24h,BRD-A84423900,10 uM,24 h,3,25,28,1,2,0,2,NEU
BRD-K94572506_10uM_24h,BRD-K94572506,10 uM,24 h,3,32,35,1,1,0,1,NEU
BRD-A48349196_10uM_6h,BRD-A48349196,10 uM,6 h,3,47,50,1,1,1,0,NEU
harmine_10uM_24h,harmine,10 uM,24 h,3,24,27,1,33,11,22,NEU
BRD-K63954456_10uM_24h,BRD-K63954456,10 uM,24 h,3,32,35,1,4,3,1,NEU
BG-1001_10uM_24h,BG-1001,10 uM,24 h,3,25,28,1,127,40,87,NEU
KW-06_10uM_6h,KW-06,10 uM,6 h,3,47,50,1,2,2,0,NEU
coumaric-acid_10uM_24h,coumaric-acid,10 uM,24 h,3,32,35,1,3,3,0,NEU
BRD-K66381707_10uM_24h,BRD-K66381707,10 uM,24 h,3,32,35,1,0,0,0,NEU
CTPB_10uM_24h,CTPB,10 uM,24 h,3,24,27,1,2,0,2,NEU
BML-210_10uM_24h,BML-210,10 uM,24 h,3,24,27,1,67,35,32,NEU
triacetylresveratrol_10uM_24h,triacetylresveratrol,10 uM,24 h,3,24,27,1,60,18,42,NEU
BRD-K09661167_10uM_24h,BRD-K09661167,10 uM,24 h,3,32,35,1,2,1,1,NEU
BRD-K86570333_10uM_24h,BRD-K86570333,10 uM,24 h,3,24,27,1,0,0,0,NEU
BRD-K51490254_10uM_6h,BRD-K51490254,10 uM,6 h,3,29,32,1,0,0,0,NEU
BRD-K06800040_10uM_24h,BRD-K06800040,10 uM,24 h,3,32,35,1,0,0,0,NEU
isonicotinohydroxamic-acid_10uM_24h,isonicotinohydroxamic-acid,10 uM,24 h,3,24,27,1,2,1,1,NEU
itdac-1_10uM_24h,itdac-1,10 uM,24 h,3,24,27,1,11,2,9,NEU
BG-1016_10uM_24h,BG-1016,10 uM,24 h,3,24,27,1,90,29,61,NEU
BRD-K51490254_10uM_24h,BRD-K51490254,10 uM,24 h,3,24,27,1,85,9,76,NEU
BRD-K93859331_10uM_24h,BRD-K93859331,10 uM,24 h,3,25,28,1,1,0,1,NEU
vanillyl-glycol_10uM_6h,vanillyl-glycol,10 uM,6 h,3,47,50,1,6,4,2,NEU
dithiothreitol_10uM_24h,dithiothreitol,10 uM,24 h,3,24,27,1,0,0,0,NEU
BRD-A17718497_10uM_24h,BRD-A17718497,10 uM,24 h,3,32,35,1,4,2,2,NEU
BRD-K13629382_10uM_24h,BRD-K13629382,10 uM,24 h,3,25,28,1,149,65,84,NEU
glutamyldopamine_10uM_24h,glutamyldopamine,10 uM,24 h,3,25,28,1,1,1,0,NEU
BRD-K00486725_10uM_24h,BRD-K00486725,10 uM,24 h,3,32,35,1,5,2,3,NEU
BRD-K13195996_10uM_6h,BRD-K13195996,10 uM,6 h,3,47,50,1,1,0,1,NEU
BRD-K89814851_10uM_24h,BRD-K89814851,10 uM,24 h,3,32,35,1,2,1,1,NEU
BRD-K10939925_10uM_24h,BRD-K10939925,10 uM,24 h,3,25,28,1,2,1,1,NEU
isosalsoline_10uM_24h,isosalsoline,10 uM,24 h,3,25,28,1,0,0,0,NEU
BRD-K81807412_10uM_24h,BRD-K81807412,10 uM,24 h,3,32,35,1,2,0,2,NEU
BRD-K86570333_10uM_6h,BRD-K86570333,10 uM,6 h,3,29,32,1,0,0,0,NEU
BRD-K11987803_10uM_24h,BRD-K11987803,10 uM,24 h,3,32,35,1,6,5,1,NEU
BRD-K82837433_10uM_24h,BRD-K82837433,10 uM,24 h,3,32,35,1,0,0,0,NEU
BRD-K89156937_10uM_24h,BRD-K89156937,10 uM,24 h,3,32,35,1,7,4,3,NEU
geranylgeraniol_10uM_6h,geranylgeraniol,10 uM,6 h,3,29,32,1,0,0,0,NEU
mevalonic-acid_10uM_6h,mevalonic-acid,10 uM,6 h,3,47,50,1,1,1,0,NEU
BRD-A88504692_10uM_24h,BRD-A88504692,10 uM,24 h,3,32,35,1,0,0,0,NEU
IAA-94_10uM_24h,IAA-94,10 uM,24 h,3,32,35,1,1,0,1,NEU
BRD-A00150179_10uM_24h,BRD-A00150179,10 uM,24 h,3,25,28,1,0,0,0,NEU
BRD-K54472228_10uM_6h,BRD-K54472228,10 uM,6 h,3,47,50,1,2,2,0,NEU
oxamflatin_10uM_6h,oxamflatin,10 uM,6 h,3,29,32,1,149,85,64,NEU
BRD-K04877770_10uM_24h,BRD-K04877770,10 uM,24 h,3,25,28,1,2,2,0,NEU
VU-0410183-2_10uM_24h,VU-0410183-2,10 uM,24 h,3,32,35,1,0,0,0,NEU
EMF-sumo1-12_10uM_24h,EMF-sumo1-12,10 uM,24 h,3,20,23,1,1,0,1,NEU
KM-04501_10uM_24h,KM-04501,10 uM,24 h,3,32,35,1,0,0,0,NEU
glycocholic-acid_10uM_24h,glycocholic-acid,10 uM,24 h,3,24,27,1,1,0,1,NEU
BRD-K94991378_10uM_24h,BRD-K94991378,10 uM,24 h,3,32,35,1,5,3,2,NEU
BRD-K39096267_10uM_24h,BRD-K39096267,10 uM,24 h,3,24,27,1,126,43,83,NEU
BRD-K39096267_10uM_6h,BRD-K39096267,10 uM,6 h,3,29,32,1,19,13,6,NEU
BRD-K61894884_10uM_24h,BRD-K61894884,10 uM,24 h,3,24,27,1,61,16,45,NEU
BG-1001_10uM_6h,BG-1001,10 uM,6 h,3,47,50,1,17,8,9,NEU
BRD-K64058329_10uM_24h,BRD-K64058329,10 uM,24 h,3,32,35,1,4,2,2,NEU
MW-A1-2_10uM_24h,MW-A1-2,10 uM,24 h,3,32,35,1,2,1,1,NEU
BG-1005_10uM_24h,BG-1005,10 uM,24 h,3,24,27,1,360,192,168,NEU
BRD-K97591839_10uM_6h,BRD-K97591839,10 uM,6 h,3,47,50,1,1,0,1,NEU
trehalose_10uM_24h,trehalose,10 uM,24 h,3,24,27,1,1,0,1,NEU
BML-286_10uM_6h,BML-286,10 uM,6 h,3,29,32,1,0,0,0,NEU
BRD-A52647795_10uM_24h,BRD-A52647795,10 uM,24 h,3,25,28,1,0,0,0,NEU
penitrem-a_10uM_24h,penitrem-a,10 uM,24 h,3,24,27,1,316,99,217,NEU
SC-68376_10uM_24h,SC-68376,10 uM,24 h,3,32,35,1,0,0,0,NEU
BRD-K18135438_10uM_6h,BRD-K18135438,10 uM,6 h,3,29,32,1,1,0,1,NEU
methoxypyruvic-acid_10uM_24h,methoxypyruvic-acid,10 uM,24 h,3,25,28,1,2,1,1,NEU
norcitalopram_10uM_6h,norcitalopram,10 uM,6 h,3,47,50,1,0,0,0,NEU
BRD-K91844626_10uM_6h,BRD-K91844626,10 uM,6 h,3,47,50,1,30,9,21,NEU
BRD-K05562558_10uM_24h,BRD-K05562558,10 uM,24 h,3,32,35,1,0,0,0,NEU
BRD-K81441552_10uM_24h,BRD-K81441552,10 uM,24 h,3,32,35,1,0,0,0,NEU
nikkomycin_10uM_24h,nikkomycin,10 uM,24 h,3,32,35,1,2,2,0,NEU
isonicotinamide_10uM_24h,isonicotinamide,10 uM,24 h,3,24,27,1,87,27,60,NEU
KDM-103_10uM_6h,KDM-103,10 uM,6 h,3,47,50,1,0,0,0,NEU
MW-A1-6_10uM_24h,MW-A1-6,10 uM,24 h,3,32,35,1,4,2,2,NEU
BRD-K55332332_10uM_6h,BRD-K55332332,10 uM,6 h,3,47,50,1,0,0,0,NEU
BAY-36-7620_10uM_24h,BAY-36-7620,10 uM,24 h,3,25,28,1,8,2,6,NEU
BRD-K36087356_10uM_24h,BRD-K36087356,10 uM,24 h,3,32,35,1,0,0,0,NEU
CTPB_10uM_6h,CTPB,10 uM,6 h,3,29,32,1,0,0,0,NEU
salsoline_10uM_6h,salsoline,10 uM,6 h,3,47,50,1,1,1,0,NEU
SR-144528_10uM_24h,SR-144528,10 uM,24 h,3,25,28,1,153,43,110,NEU
IWP-2_10uM_24h,IWP-2,10 uM,24 h,3,24,27,1,172,55,117,NEU
rotenonic-acid_10uM_24h,rotenonic-acid,10 uM,24 h,3,32,35,1,0,0,0,NEU
BG-1011_10uM_24h,BG-1011,10 uM,24 h,3,24,27,1,17,7,10,NEU
norcitalopram_10uM_24h,norcitalopram,10 uM,24 h,3,25,28,1,86,29,57,NEU
tropapride_10uM_6h,tropapride,10 uM,6 h,3,47,50,1,0,0,0,NEU
BRD-K48823327_10uM_24h,BRD-K48823327,10 uM,24 h,3,32,35,1,0,0,0,NEU
BRD-K42568865_10uM_24h,BRD-K42568865,10 uM,24 h,3,32,35,1,2,0,2,NEU
BOX-5_10uM_24h,BOX-5,10 uM,24 h,3,24,27,1,0,0,0,NEU
BRD-K76108747_10uM_24h,BRD-K76108747,10 uM,24 h,3,25,28,1,0,0,0,NEU
BRD-A77098556_10uM_6h,BRD-A77098556,10 uM,6 h,3,47,50,1,0,0,0,NEU
tetramethyl-haematoxylone_10uM_24h,tetramethyl-haematoxylone,10 uM,24 h,3,32,35,1,0,0,0,NEU
dinorcitalopram-oxalate_10uM_24h,dinorcitalopram-oxalate,10 uM,24 h,3,25,28,1,27,4,23,NEU
diarylsulfonesulfonamide_10uM_24h,diarylsulfonesulfonamide,10 uM,24 h,3,24,27,1,10,6,4,NEU
spiramide_10uM_24h,spiramide,10 uM,24 h,3,32,35,1,0,0,0,NEU
BRD-K13528168_10uM_24h,BRD-K13528168,10 uM,24 h,3,25,28,1,115,30,85,NEU
tropapride_10uM_24h,tropapride,10 uM,24 h,3,25,28,1,0,0,0,NEU
ST-4070043_10uM_24h,ST-4070043,10 uM,24 h,3,32,35,1,0,0,0,NEU
BRD-A30455275_10uM_24h,BRD-A30455275,10 uM,24 h,3,32,35,1,31,14,17,NEU
thenoyltrifluoroacetone_10uM_6h,thenoyltrifluoroacetone,10 uM,6 h,3,29,32,1,0,0,0,NEU
BRD-A94494639_10uM_24h,BRD-A94494639,10 uM,24 h,3,25,28,1,0,0,0,NEU
BG-1028_10uM_24h,BG-1028,10 uM,24 h,3,24,27,1,425,213,212,NEU
BRD-M28563253_10uM_24h,BRD-M28563253,10 uM,24 h,3,25,28,1,0,0,0,NEU
usnic-acid_10uM_24h,usnic-acid,10 uM,24 h,3,24,27,1,33,9,24,NEU
GSK-429286A_0.04uM_24h,GSK-429286A,0.04 uM,24 h,3,65,68,1,16,2,14,NEU
XMD-1499_0.04uM_24h,XMD-1499,0.04 uM,24 h,3,65,68,1,23,16,7,NEU
SGX-523_0.04uM_24h,SGX-523,0.04 uM,24 h,3,65,68,1,0,0,0,NEU
KIN001-260_0.04uM_24h,KIN001-260,0.04 uM,24 h,3,65,68,1,0,0,0,NEU
QL-XI-92_0.04uM_24h,QL-XI-92,0.04 uM,24 h,3,65,68,1,0,0,0,NEU
AZD-1480_0.04uM_24h,AZD-1480,0.04 uM,24 h,3,65,68,1,2,0,2,NEU
JNK-IN-5A_0.04uM_24h,JNK-IN-5A,0.04 uM,24 h,3,65,68,1,0,0,0,NEU
KIN-001-220_0.04uM_24h,KIN-001-220,0.04 uM,24 h,3,65,68,1,1,0,1,NEU
MLN-8054_0.04uM_24h,MLN-8054,0.04 uM,24 h,3,65,68,1,4,0,4,NEU
KIN001-242_0.04uM_24h,KIN001-242,0.04 uM,24 h,3,65,68,1,2,1,1,NEU
CG-930_0.04uM_24h,CG-930,0.04 uM,24 h,3,65,68,1,0,0,0,NEU
RAF-265_0.04uM_24h,RAF-265,0.04 uM,24 h,3,65,68,1,3,1,2,NEU
GSK-2334470_0.04uM_24h,GSK-2334470,0.04 uM,24 h,3,65,68,1,0,0,0,NEU
BRD-A92800748_0.04uM_24h,BRD-A92800748,0.04 uM,24 h,3,65,68,1,3,1,2,NEU
JWE-035_0.04uM_24h,JWE-035,0.04 uM,24 h,3,65,68,1,1,1,0,NEU
XMD-892_0.04uM_24h,XMD-892,0.04 uM,24 h,3,65,68,1,0,0,0,NEU
AZD-7762_0.04uM_24h,AZD-7762,0.04 uM,24 h,3,65,68,1,2,2,0,NEU
KIN001-269_0.04uM_24h,KIN001-269,0.04 uM,24 h,3,65,68,1,1,1,0,NEU
ALW-II-38-3_0.04uM_24h,ALW-II-38-3,0.04 uM,24 h,3,65,68,1,0,0,0,NEU
BRD-K29983336_0.04uM_24h,BRD-K29983336,0.04 uM,24 h,3,65,68,1,1,0,1,NEU
KIN001-127_0.04uM_24h,KIN001-127,0.04 uM,24 h,3,65,68,1,0,0,0,NEU
SGX-523_0.12uM_24h,SGX-523,0.12 uM,24 h,3,65,68,1,2,1,1,NEU
QL-XI-92_0.12uM_24h,QL-XI-92,0.12 uM,24 h,3,65,68,1,1,1,0,NEU
KIN001-055_0.12uM_24h,KIN001-055,0.12 uM,24 h,3,65,68,1,1,1,0,NEU
KIN001-269_0.12uM_24h,KIN001-269,0.12 uM,24 h,3,65,68,1,0,0,0,NEU
BRD-A92800748_0.12uM_24h,BRD-A92800748,0.12 uM,24 h,3,65,68,1,0,0,0,NEU
KIN001-127_0.12uM_24h,KIN001-127,0.12 uM,24 h,3,65,68,1,0,0,0,NEU
GSK-429286A_0.12uM_24h,GSK-429286A,0.12 uM,24 h,3,65,68,1,37,12,25,NEU
XMD-892_0.12uM_24h,XMD-892,0.12 uM,24 h,3,65,68,1,4,2,2,NEU
KIN001-242_0.12uM_24h,KIN001-242,0.12 uM,24 h,3,65,68,1,0,0,0,NEU
BRD-K29983336_0.12uM_24h,BRD-K29983336,0.12 uM,24 h,3,65,68,1,5,4,1,NEU
AZD-1480_0.12uM_24h,AZD-1480,0.12 uM,24 h,3,65,68,1,0,0,0,NEU
RAF-265_0.12uM_24h,RAF-265,0.12 uM,24 h,3,65,68,1,7,7,0,NEU
GSK-2334470_0.12uM_24h,GSK-2334470,0.12 uM,24 h,3,65,68,1,1,0,1,NEU
AZD-7762_0.12uM_24h,AZD-7762,0.12 uM,24 h,3,65,68,1,1,1,0,NEU
JNK-IN-5A_0.12uM_24h,JNK-IN-5A,0.12 uM,24 h,3,65,68,1,9,6,3,NEU
JWE-035_0.12uM_24h,JWE-035,0.12 uM,24 h,3,65,68,1,11,8,3,NEU
ALW-II-38-3_0.12uM_24h,ALW-II-38-3,0.12 uM,24 h,3,65,68,1,0,0,0,NEU
XMD-1499_0.12uM_24h,XMD-1499,0.12 uM,24 h,3,65,68,1,2,1,1,NEU
chelerythrine_0.12uM_24h,chelerythrine,0.12 uM,24 h,3,65,68,1,0,0,0,NEU
KIN001-260_0.12uM_24h,KIN001-260,0.12 uM,24 h,3,65,68,1,0,0,0,NEU
KIN-001-220_0.12uM_24h,KIN-001-220,0.12 uM,24 h,3,65,68,1,3,1,2,NEU
CG-930_0.12uM_24h,CG-930,0.12 uM,24 h,3,65,68,1,1,1,0,NEU
JWE-035_0.37uM_24h,JWE-035,0.37 uM,24 h,3,65,68,1,2,0,2,NEU
ALW-II-38-3_0.37uM_24h,ALW-II-38-3,0.37 uM,24 h,3,65,68,1,3,2,1,NEU
AZD-7762_0.37uM_24h,AZD-7762,0.37 uM,24 h,3,65,68,1,1,1,0,NEU
BRD-K29983336_0.37uM_24h,BRD-K29983336,0.37 uM,24 h,3,65,68,1,0,0,0,NEU
XMD-1499_0.37uM_24h,XMD-1499,0.37 uM,24 h,3,65,68,1,2,0,2,NEU
KIN001-269_0.37uM_24h,KIN001-269,0.37 uM,24 h,3,65,68,1,0,0,0,NEU
KIN001-260_0.37uM_24h,KIN001-260,0.37 uM,24 h,3,65,68,1,2,2,0,NEU
XMD-892_0.37uM_24h,XMD-892,0.37 uM,24 h,3,65,68,1,1,1,0,NEU
RAF-265_0.37uM_24h,RAF-265,0.37 uM,24 h,3,65,68,1,13,11,2,NEU
KIN-001-220_0.37uM_24h,KIN-001-220,0.37 uM,24 h,3,65,68,1,0,0,0,NEU
GSK-429286A_0.37uM_24h,GSK-429286A,0.37 uM,24 h,3,65,68,1,18,3,15,NEU
BRD-A92800748_0.37uM_24h,BRD-A92800748,0.37 uM,24 h,3,65,68,1,3,3,0,NEU
GSK-2334470_0.37uM_24h,GSK-2334470,0.37 uM,24 h,3,65,68,1,2,1,1,NEU
JNK-IN-5A_0.37uM_24h,JNK-IN-5A,0.37 uM,24 h,3,65,68,1,11,9,2,NEU
AZD-1480_0.37uM_24h,AZD-1480,0.37 uM,24 h,3,65,68,1,0,0,0,NEU
KIN001-055_0.37uM_24h,KIN001-055,0.37 uM,24 h,3,65,68,1,2,2,0,NEU
chelerythrine_0.37uM_24h,chelerythrine,0.37 uM,24 h,3,65,68,1,3,2,1,NEU
QL-XI-92_0.37uM_24h,QL-XI-92,0.37 uM,24 h,3,65,68,1,2,1,1,NEU
KIN001-242_0.37uM_24h,KIN001-242,0.37 uM,24 h,3,65,68,1,3,1,2,NEU
SGX-523_0.37uM_24h,SGX-523,0.37 uM,24 h,3,65,68,1,2,1,1,NEU
MLN-8054_0.37uM_24h,MLN-8054,0.37 uM,24 h,3,65,68,1,4,4,0,NEU
CG-930_0.37uM_24h,CG-930,0.37 uM,24 h,3,65,68,1,0,0,0,NEU
KIN001-127_0.37uM_24h,KIN001-127,0.37 uM,24 h,3,65,68,1,6,2,4,NEU
chelerythrine_1.11uM_24h,chelerythrine,1.11 uM,24 h,3,65,68,1,2,1,1,NEU
XMD-1499_1.11uM_24h,XMD-1499,1.11 uM,24 h,3,65,68,1,0,0,0,NEU
GSK-2334470_1.11uM_24h,GSK-2334470,1.11 uM,24 h,3,65,68,1,0,0,0,NEU
RAF-265_1.11uM_24h,RAF-265,1.11 uM,24 h,3,65,68,1,9,8,1,NEU
bafilomycin_1.11uM_6h,bafilomycin,1.11 uM,6 h,3,29,32,1,0,0,0,NEU
KIN001-055_1.11uM_24h,KIN001-055,1.11 uM,24 h,3,65,68,1,0,0,0,NEU
JWE-035_1.11uM_24h,JWE-035,1.11 uM,24 h,3,65,68,1,2,2,0,NEU
BRD-K29983336_1.11uM_24h,BRD-K29983336,1.11 uM,24 h,3,65,68,1,7,5,2,NEU
XMD-892_1.11uM_24h,XMD-892,1.11 uM,24 h,3,65,68,1,0,0,0,NEU
BRD-A92800748_1.11uM_24h,BRD-A92800748,1.11 uM,24 h,3,65,68,1,0,0,0,NEU
KIN001-127_1.11uM_24h,KIN001-127,1.11 uM,24 h,3,65,68,1,0,0,0,NEU
CG-930_1.11uM_24h,CG-930,1.11 uM,24 h,3,65,68,1,0,0,0,NEU
QL-XI-92_1.11uM_24h,QL-XI-92,1.11 uM,24 h,3,65,68,1,1,1,0,NEU
KIN001-269_1.11uM_24h,KIN001-269,1.11 uM,24 h,3,65,68,1,3,2,1,NEU
ALW-II-38-3_1.11uM_24h,ALW-II-38-3,1.11 uM,24 h,3,65,68,1,2,1,1,NEU
MLN-8054_1.11uM_24h,MLN-8054,1.11 uM,24 h,3,65,68,1,4,4,0,NEU
bafilomycin_1.11uM_24h,bafilomycin,1.11 uM,24 h,3,24,27,1,320,102,218,NEU
KIN001-260_1.11uM_24h,KIN001-260,1.11 uM,24 h,3,65,68,1,4,3,1,NEU
JNK-IN-5A_1.11uM_24h,JNK-IN-5A,1.11 uM,24 h,3,65,68,1,3,3,0,NEU
AZD-1480_1.11uM_24h,AZD-1480,1.11 uM,24 h,3,65,68,1,0,0,0,NEU
AZD-7762_1.11uM_24h,AZD-7762,1.11 uM,24 h,3,65,68,1,2,1,1,NEU
KIN001-242_1.11uM_24h,KIN001-242,1.11 uM,24 h,3,65,68,1,0,0,0,NEU
SGX-523_1.11uM_24h,SGX-523,1.11 uM,24 h,3,65,68,1,4,3,1,NEU
KIN001-055_3.33uM_24h,KIN001-055,3.33 uM,24 h,3,65,68,1,3,2,1,NEU
JNK-IN-5A_3.33uM_24h,JNK-IN-5A,3.33 uM,24 h,3,65,68,1,6,5,1,NEU
chelerythrine_3.33uM_24h,chelerythrine,3.33 uM,24 h,3,65,68,1,2,0,2,NEU
GSK-429286A_3.33uM_24h,GSK-429286A,3.33 uM,24 h,3,65,68,1,68,39,29,NEU
CG-930_3.33uM_24h,CG-930,3.33 uM,24 h,3,65,68,1,0,0,0,NEU
KIN001-242_3.33uM_24h,KIN001-242,3.33 uM,24 h,3,65,68,1,1,1,0,NEU
BRD-A92800748_3.33uM_24h,BRD-A92800748,3.33 uM,24 h,3,65,68,1,1,1,0,NEU
AZD-1480_3.33uM_24h,AZD-1480,3.33 uM,24 h,3,65,68,1,1,1,0,NEU
MLN-8054_3.33uM_24h,MLN-8054,3.33 uM,24 h,3,65,68,1,0,0,0,NEU
XMD-1499_3.33uM_24h,XMD-1499,3.33 uM,24 h,3,65,68,1,1,0,1,NEU
KIN001-127_3.33uM_24h,KIN001-127,3.33 uM,24 h,3,65,68,1,16,5,11,NEU
KIN001-260_3.33uM_24h,KIN001-260,3.33 uM,24 h,3,65,68,1,0,0,0,NEU
SGX-523_3.33uM_24h,SGX-523,3.33 uM,24 h,3,65,68,1,0,0,0,NEU
XMD-892_3.33uM_24h,XMD-892,3.33 uM,24 h,3,65,68,1,1,1,0,NEU
LY-294002_3.33uM_24h,LY-294002,3.33 uM,24 h,3,44,47,2,187,66,121,NEU
JWE-035_3.33uM_24h,JWE-035,3.33 uM,24 h,3,65,68,1,2,1,1,NEU
RAF-265_3.33uM_24h,RAF-265,3.33 uM,24 h,3,65,68,1,8,7,1,NEU
GSK-2334470_3.33uM_24h,GSK-2334470,3.33 uM,24 h,3,65,68,1,1,1,0,NEU
KIN-001-220_3.33uM_24h,KIN-001-220,3.33 uM,24 h,3,65,68,1,5,4,1,NEU
QL-XI-92_3.33uM_24h,QL-XI-92,3.33 uM,24 h,3,65,68,1,2,1,1,NEU
BRD-K29983336_3.33uM_24h,BRD-K29983336,3.33 uM,24 h,3,65,68,1,0,0,0,NEU
ALW-II-38-3_3.33uM_24h,ALW-II-38-3,3.33 uM,24 h,3,65,68,1,4,3,1,NEU
KIN001-269_3.33uM_24h,KIN001-269,3.33 uM,24 h,3,65,68,1,0,0,0,NEU
masitinib_10uM_24h,masitinib,10 uM,24 h,3,66,69,1,21,10,11,MNEU
SGI-1776_10uM_24h,SGI-1776,10 uM,24 h,3,66,69,1,295,151,144,MNEU
bosutinib_10uM_24h,bosutinib,10 uM,24 h,3,66,69,1,59,48,11,MNEU
dacomitinib_10uM_24h,dacomitinib,10 uM,24 h,3,66,69,1,118,73,45,MNEU
OSI-930_10uM_24h,OSI-930,10 uM,24 h,3,66,69,1,13,11,2,MNEU
everolimus_10uM_24h,everolimus,10 uM,24 h,3,66,69,1,8,5,3,MNEU
NVP-TAE226_10uM_24h,NVP-TAE226,10 uM,24 h,3,66,69,1,118,49,69,MNEU
sunitinib_10uM_24h,sunitinib,10 uM,24 h,3,66,69,1,455,186,269,MNEU
BMS-777607_10uM_24h,BMS-777607,10 uM,24 h,3,66,69,1,7,4,3,MNEU
PD-0325901_10uM_24h,PD-0325901,10 uM,24 h,3,66,69,1,43,19,24,MNEU
AZ-628_10uM_24h,AZ-628,10 uM,24 h,3,66,69,1,38,16,22,MNEU
SB-216763_10uM_24h,SB-216763,10 uM,24 h,3,66,69,1,26,7,19,MNEU
cabozantinib_10uM_24h,cabozantinib,10 uM,24 h,3,66,69,1,37,27,10,MNEU
AST-1306_10uM_24h,AST-1306,10 uM,24 h,3,66,69,1,37,29,8,MNEU
dinaciclib_10uM_24h,dinaciclib,10 uM,24 h,3,66,69,1,578,258,320,MNEU
vandetanib_10uM_24h,vandetanib,10 uM,24 h,3,66,69,1,164,72,92,MNEU
motesanib_10uM_24h,motesanib,10 uM,24 h,3,66,69,1,15,7,8,MNEU
idelalisib_10uM_24h,idelalisib,10 uM,24 h,3,66,69,1,373,146,227,MNEU
pazopanib_10uM_24h,pazopanib,10 uM,24 h,3,66,69,1,33,23,10,MNEU
doramapimod_10uM_24h,doramapimod,10 uM,24 h,3,66,69,1,2,1,1,MNEU
dasatinib_10uM_24h,dasatinib,10 uM,24 h,3,66,69,1,43,24,19,MNEU
SAR-245409_10uM_24h,SAR-245409,10 uM,24 h,3,66,69,1,30,11,19,MNEU
sirolimus_10uM_24h,sirolimus,10 uM,24 h,3,66,69,1,7,6,1,MNEU
TPCA-1_10uM_24h,TPCA-1,10 uM,24 h,3,66,69,1,83,44,39,MNEU
tivantinib_10uM_24h,tivantinib,10 uM,24 h,3,66,69,1,92,46,46,MNEU
tanespimycin_10uM_24h,tanespimycin,10 uM,24 h,3,66,69,1,41,20,21,MNEU
BIX-02189_10uM_24h,BIX-02189,10 uM,24 h,3,66,69,1,25,17,8,MNEU
ibrutinib_10uM_24h,ibrutinib,10 uM,24 h,3,66,69,1,15,11,4,MNEU
PF-04217903_10uM_24h,PF-04217903,10 uM,24 h,3,66,69,1,8,7,1,MNEU
GDC-0068_10uM_24h,GDC-0068,10 uM,24 h,3,66,69,1,26,13,13,MNEU
KW-2449_10uM_24h,KW-2449,10 uM,24 h,3,66,69,1,77,50,27,MNEU
rebastinib_10uM_24h,rebastinib,10 uM,24 h,3,66,69,1,536,229,307,MNEU
NVP-BGJ398_10uM_24h,NVP-BGJ398,10 uM,24 h,3,66,69,1,107,82,25,MNEU
WZ-4002_10uM_24h,WZ-4002,10 uM,24 h,3,66,69,1,11,9,2,MNEU
quizartinib_10uM_24h,quizartinib,10 uM,24 h,3,66,69,1,28,11,17,MNEU
FR-180204_10uM_24h,FR-180204,10 uM,24 h,3,66,69,1,6,4,2,MNEU
SB-525334_10uM_24h,SB-525334,10 uM,24 h,3,66,69,1,7,2,5,MNEU
BS-181_10uM_24h,BS-181,10 uM,24 h,3,66,69,1,364,169,195,MNEU
tivozanib_10uM_24h,tivozanib,10 uM,24 h,3,66,69,1,83,43,40,MNEU
amuvatinib_10uM_24h,amuvatinib,10 uM,24 h,3,66,69,1,35,19,16,MNEU
KW-2449_0.04uM_24h,KW-2449,0.04 uM,24 h,3,66,69,1,2,1,1,MNEU
idelalisib_0.04uM_24h,idelalisib,0.04 uM,24 h,3,66,69,1,7,5,2,MNEU
everolimus_0.04uM_24h,everolimus,0.04 uM,24 h,3,66,69,1,254,104,150,MNEU
BMS-777607_0.04uM_24h,BMS-777607,0.04 uM,24 h,3,66,69,1,1,1,0,MNEU
SB-216763_0.04uM_24h,SB-216763,0.04 uM,24 h,3,66,69,1,99,26,73,MNEU
AZ-628_0.04uM_24h,AZ-628,0.04 uM,24 h,3,66,69,1,13,7,6,MNEU
sunitinib_0.04uM_24h,sunitinib,0.04 uM,24 h,3,66,69,1,3,3,0,MNEU
SB-525334_0.04uM_24h,SB-525334,0.04 uM,24 h,3,66,69,1,4,1,3,MNEU
dinaciclib_0.04uM_24h,dinaciclib,0.04 uM,24 h,3,66,69,1,591,276,315,MNEU
doramapimod_0.04uM_24h,doramapimod,0.04 uM,24 h,3,66,69,1,0,0,0,MNEU
WZ-4002_0.04uM_24h,WZ-4002,0.04 uM,24 h,3,66,69,1,0,0,0,MNEU
BS-181_0.04uM_24h,BS-181,0.04 uM,24 h,3,66,69,1,2,1,1,MNEU
quizartinib_0.04uM_24h,quizartinib,0.04 uM,24 h,3,66,69,1,7,3,4,MNEU
cabozantinib_0.04uM_24h,cabozantinib,0.04 uM,24 h,3,66,69,1,7,4,3,MNEU
NVP-TAE226_0.04uM_24h,NVP-TAE226,0.04 uM,24 h,3,66,69,1,6,2,4,MNEU
dasatinib_0.04uM_24h,dasatinib,0.04 uM,24 h,3,66,69,1,24,8,16,MNEU
dacomitinib_0.04uM_24h,dacomitinib,0.04 uM,24 h,3,66,69,1,8,3,5,MNEU
TPCA-1_0.04uM_24h,TPCA-1,0.04 uM,24 h,3,66,69,1,16,6,10,MNEU
vandetanib_0.04uM_24h,vandetanib,0.04 uM,24 h,3,66,69,1,74,40,34,MNEU
ibrutinib_0.04uM_24h,ibrutinib,0.04 uM,24 h,3,66,69,1,2,1,1,MNEU
pazopanib_0.04uM_24h,pazopanib,0.04 uM,24 h,3,66,69,1,4,3,1,MNEU
rebastinib_0.04uM_24h,rebastinib,0.04 uM,24 h,3,66,69,1,8,3,5,MNEU
PHA-767491_0.04uM_24h,PHA-767491,0.04 uM,24 h,3,66,69,1,2,2,0,MNEU
FR-180204_0.04uM_24h,FR-180204,0.04 uM,24 h,3,66,69,1,0,0,0,MNEU
tivozanib_0.04uM_24h,tivozanib,0.04 uM,24 h,3,66,69,1,5,2,3,MNEU
BIX-02189_0.04uM_24h,BIX-02189,0.04 uM,24 h,3,66,69,1,0,0,0,MNEU
bosutinib_0.04uM_24h,bosutinib,0.04 uM,24 h,3,66,69,1,9,4,5,MNEU
OSI-930_0.04uM_24h,OSI-930,0.04 uM,24 h,3,66,69,1,5,1,4,MNEU
tivantinib_0.04uM_24h,tivantinib,0.04 uM,24 h,3,66,69,1,3,2,1,MNEU
amuvatinib_0.04uM_24h,amuvatinib,0.04 uM,24 h,3,66,69,1,16,7,9,MNEU
AST-1306_0.04uM_24h,AST-1306,0.04 uM,24 h,3,66,69,1,4,2,2,MNEU
SAR-245409_0.04uM_24h,SAR-245409,0.04 uM,24 h,3,66,69,1,10,4,6,MNEU
PD-0325901_0.04uM_24h,PD-0325901,0.04 uM,24 h,3,66,69,1,10,9,1,MNEU
SGI-1776_0.04uM_24h,SGI-1776,0.04 uM,24 h,3,66,69,1,8,8,0,MNEU
masitinib_0.04uM_24h,masitinib,0.04 uM,24 h,3,66,69,1,81,28,53,MNEU
GDC-0068_0.04uM_24h,GDC-0068,0.04 uM,24 h,3,66,69,1,4,3,1,MNEU
motesanib_0.04uM_24h,motesanib,0.04 uM,24 h,3,66,69,1,5,2,3,MNEU
PF-04217903_0.04uM_24h,PF-04217903,0.04 uM,24 h,3,66,69,1,8,4,4,MNEU
dasatinib_0.12uM_24h,dasatinib,0.12 uM,24 h,3,66,69,1,30,12,18,MNEU
NVP-BGJ398_0.12uM_24h,NVP-BGJ398,0.12 uM,24 h,3,66,69,1,81,49,32,MNEU
PHA-767491_0.12uM_24h,PHA-767491,0.12 uM,24 h,3,66,69,1,0,0,0,MNEU
rebastinib_0.12uM_24h,rebastinib,0.12 uM,24 h,3,66,69,1,32,16,16,MNEU
masitinib_0.12uM_24h,masitinib,0.12 uM,24 h,3,66,69,1,8,3,5,MNEU
TPCA-1_0.12uM_24h,TPCA-1,0.12 uM,24 h,3,66,69,1,16,7,9,MNEU
dacomitinib_0.12uM_24h,dacomitinib,0.12 uM,24 h,3,66,69,1,9,8,1,MNEU
WZ-4002_0.12uM_24h,WZ-4002,0.12 uM,24 h,3,66,69,1,2,1,1,MNEU
pazopanib_0.12uM_24h,pazopanib,0.12 uM,24 h,3,66,69,1,2,1,1,MNEU
BS-181_0.12uM_24h,BS-181,0.12 uM,24 h,3,66,69,1,8,7,1,MNEU
KW-2449_0.12uM_24h,KW-2449,0.12 uM,24 h,3,66,69,1,7,6,1,MNEU
AST-1306_0.12uM_24h,AST-1306,0.12 uM,24 h,3,66,69,1,1,0,1,MNEU
SB-216763_0.12uM_24h,SB-216763,0.12 uM,24 h,3,66,69,1,24,13,11,MNEU
GDC-0068_0.12uM_24h,GDC-0068,0.12 uM,24 h,3,66,69,1,10,7,3,MNEU
FR-180204_0.12uM_24h,FR-180204,0.12 uM,24 h,3,66,69,1,4,3,1,MNEU
bosutinib_0.12uM_24h,bosutinib,0.12 uM,24 h,3,66,69,1,23,6,17,MNEU
AZ-628_0.12uM_24h,AZ-628,0.12 uM,24 h,3,66,69,1,9,4,5,MNEU
SGI-1776_0.12uM_24h,SGI-1776,0.12 uM,24 h,3,66,69,1,1,1,0,MNEU
SB-525334_0.12uM_24h,SB-525334,0.12 uM,24 h,3,66,69,1,3,3,0,MNEU
idelalisib_0.12uM_24h,idelalisib,0.12 uM,24 h,3,66,69,1,47,28,19,MNEU
CGP-60474_0.12uM_24h,CGP-60474,0.12 uM,24 h,3,66,69,1,544,262,282,MNEU
everolimus_0.12uM_24h,everolimus,0.12 uM,24 h,3,66,69,1,128,48,80,MNEU
tivantinib_0.12uM_24h,tivantinib,0.12 uM,24 h,3,66,69,1,4,1,3,MNEU
tivozanib_0.12uM_24h,tivozanib,0.12 uM,24 h,3,66,69,1,12,9,3,MNEU
SAR-245409_0.12uM_24h,SAR-245409,0.12 uM,24 h,3,66,69,1,7,4,3,MNEU
sunitinib_0.12uM_24h,sunitinib,0.12 uM,24 h,3,66,69,1,4,3,1,MNEU
amuvatinib_0.12uM_24h,amuvatinib,0.12 uM,24 h,3,66,69,1,12,11,1,MNEU
quizartinib_0.12uM_24h,quizartinib,0.12 uM,24 h,3,66,69,1,2,0,2,MNEU
OSI-930_0.12uM_24h,OSI-930,0.12 uM,24 h,3,66,69,1,281,61,220,MNEU
BIX-02189_0.12uM_24h,BIX-02189,0.12 uM,24 h,3,66,69,1,8,3,5,MNEU
motesanib_0.12uM_24h,motesanib,0.12 uM,24 h,3,66,69,1,12,6,6,MNEU
ibrutinib_0.12uM_24h,ibrutinib,0.12 uM,24 h,3,66,69,1,3,3,0,MNEU
NVP-TAE226_0.12uM_24h,NVP-TAE226,0.12 uM,24 h,3,66,69,1,21,7,14,MNEU
vandetanib_0.12uM_24h,vandetanib,0.12 uM,24 h,3,66,69,1,0,0,0,MNEU
PD-0325901_0.12uM_24h,PD-0325901,0.12 uM,24 h,3,66,69,1,1,1,0,MNEU
BMS-777607_0.12uM_24h,BMS-777607,0.12 uM,24 h,3,66,69,1,0,0,0,MNEU
cabozantinib_0.12uM_24h,cabozantinib,0.12 uM,24 h,3,66,69,1,5,3,2,MNEU
PF-04217903_0.12uM_24h,PF-04217903,0.12 uM,24 h,3,66,69,1,3,2,1,MNEU
doramapimod_0.37uM_24h,doramapimod,0.37 uM,24 h,3,66,69,1,2,1,1,MNEU
tivozanib_0.37uM_24h,tivozanib,0.37 uM,24 h,3,66,69,1,10,0,10,MNEU
sunitinib_0.37uM_24h,sunitinib,0.37 uM,24 h,3,66,69,1,25,12,13,MNEU
TPCA-1_0.37uM_24h,TPCA-1,0.37 uM,24 h,3,66,69,1,30,19,11,MNEU
SGI-1776_0.37uM_24h,SGI-1776,0.37 uM,24 h,3,66,69,1,2,1,1,MNEU
cabozantinib_0.37uM_24h,cabozantinib,0.37 uM,24 h,3,66,69,1,12,10,2,MNEU
WZ-4002_0.37uM_24h,WZ-4002,0.37 uM,24 h,3,66,69,1,19,6,13,MNEU
quizartinib_0.37uM_24h,quizartinib,0.37 uM,24 h,3,66,69,1,16,0,16,MNEU
FR-180204_0.37uM_24h,FR-180204,0.37 uM,24 h,3,66,69,1,8,5,3,MNEU
bosutinib_0.37uM_24h,bosutinib,0.37 uM,24 h,3,66,69,1,1,1,0,MNEU
SAR-245409_0.37uM_24h,SAR-245409,0.37 uM,24 h,3,66,69,1,5,1,4,MNEU
pazopanib_0.37uM_24h,pazopanib,0.37 uM,24 h,3,66,69,1,5,2,3,MNEU
OSI-930_0.37uM_24h,OSI-930,0.37 uM,24 h,3,66,69,1,20,11,9,MNEU
BS-181_0.37uM_24h,BS-181,0.37 uM,24 h,3,66,69,1,8,6,2,MNEU
NVP-BGJ398_0.37uM_24h,NVP-BGJ398,0.37 uM,24 h,3,66,69,1,60,49,11,MNEU
BIX-02189_0.37uM_24h,BIX-02189,0.37 uM,24 h,3,66,69,1,4,1,3,MNEU
dacomitinib_0.37uM_24h,dacomitinib,0.37 uM,24 h,3,66,69,1,6,3,3,MNEU
everolimus_0.37uM_24h,everolimus,0.37 uM,24 h,3,66,69,1,26,7,19,MNEU
vandetanib_0.37uM_24h,vandetanib,0.37 uM,24 h,3,66,69,1,62,31,31,MNEU
NVP-TAE226_0.37uM_24h,NVP-TAE226,0.37 uM,24 h,3,66,69,1,55,17,38,MNEU
tivantinib_0.37uM_24h,tivantinib,0.37 uM,24 h,3,66,69,1,1,1,0,MNEU
SB-525334_0.37uM_24h,SB-525334,0.37 uM,24 h,3,66,69,1,3,1,2,MNEU
SB-216763_0.37uM_24h,SB-216763,0.37 uM,24 h,3,66,69,1,6,2,4,MNEU
KW-2449_0.37uM_24h,KW-2449,0.37 uM,24 h,3,66,69,1,18,14,4,MNEU
motesanib_0.37uM_24h,motesanib,0.37 uM,24 h,3,66,69,1,11,8,3,MNEU
masitinib_0.37uM_24h,masitinib,0.37 uM,24 h,3,66,69,1,5,3,2,MNEU
rebastinib_0.37uM_24h,rebastinib,0.37 uM,24 h,3,66,69,1,2,0,2,MNEU
BMS-777607_0.37uM_24h,BMS-777607,0.37 uM,24 h,3,66,69,1,1,1,0,MNEU
ibrutinib_0.37uM_24h,ibrutinib,0.37 uM,24 h,3,66,69,1,7,5,2,MNEU
AZ-628_0.37uM_24h,AZ-628,0.37 uM,24 h,3,66,69,1,7,4,3,MNEU
idelalisib_0.37uM_24h,idelalisib,0.37 uM,24 h,3,66,69,1,5,4,1,MNEU
PF-04217903_0.37uM_24h,PF-04217903,0.37 uM,24 h,3,66,69,1,9,4,5,MNEU
GDC-0068_0.37uM_24h,GDC-0068,0.37 uM,24 h,3,66,69,1,9,6,3,MNEU
PD-0325901_0.37uM_24h,PD-0325901,0.37 uM,24 h,3,66,69,1,3,1,2,MNEU
dasatinib_0.37uM_24h,dasatinib,0.37 uM,24 h,3,66,69,1,33,9,24,MNEU
PHA-767491_0.37uM_24h,PHA-767491,0.37 uM,24 h,3,66,69,1,9,6,3,MNEU
amuvatinib_0.37uM_24h,amuvatinib,0.37 uM,24 h,3,66,69,1,5,3,2,MNEU
rebastinib_1.11uM_24h,rebastinib,1.11 uM,24 h,3,66,69,1,3,0,3,MNEU
OSI-930_1.11uM_24h,OSI-930,1.11 uM,24 h,3,66,69,1,17,10,7,MNEU
BMS-777607_1.11uM_24h,BMS-777607,1.11 uM,24 h,3,66,69,1,2,2,0,MNEU
SB-525334_1.11uM_24h,SB-525334,1.11 uM,24 h,3,66,69,1,4,1,3,MNEU
BIX-02189_1.11uM_24h,BIX-02189,1.11 uM,24 h,3,66,69,1,0,0,0,MNEU
amuvatinib_1.11uM_24h,amuvatinib,1.11 uM,24 h,3,66,69,1,4,0,4,MNEU
SB-216763_1.11uM_24h,SB-216763,1.11 uM,24 h,3,66,69,1,6,5,1,MNEU
vandetanib_1.11uM_24h,vandetanib,1.11 uM,24 h,3,66,69,1,1,1,0,MNEU
WZ-4002_1.11uM_24h,WZ-4002,1.11 uM,24 h,3,66,69,1,4,0,4,MNEU
dasatinib_1.11uM_24h,dasatinib,1.11 uM,24 h,3,66,69,1,31,8,23,MNEU
dacomitinib_1.11uM_24h,dacomitinib,1.11 uM,24 h,3,66,69,1,4,1,3,MNEU
AZ-628_1.11uM_24h,AZ-628,1.11 uM,24 h,3,66,69,1,6,1,5,MNEU
tivantinib_1.11uM_24h,tivantinib,1.11 uM,24 h,3,66,69,1,29,9,20,MNEU
NVP-BGJ398_1.11uM_24h,NVP-BGJ398,1.11 uM,24 h,3,66,69,1,22,19,3,MNEU
tivozanib_1.11uM_24h,tivozanib,1.11 uM,24 h,3,66,69,1,2,2,0,MNEU
PHA-767491_1.11uM_24h,PHA-767491,1.11 uM,24 h,3,66,69,1,18,8,10,MNEU
FR-180204_1.11uM_24h,FR-180204,1.11 uM,24 h,3,66,69,1,5,2,3,MNEU
NVP-TAE226_1.11uM_24h,NVP-TAE226,1.11 uM,24 h,3,66,69,1,63,21,42,MNEU
SGI-1776_1.11uM_24h,SGI-1776,1.11 uM,24 h,3,66,69,1,8,6,2,MNEU
SAR-245409_1.11uM_24h,SAR-245409,1.11 uM,24 h,3,66,69,1,1,1,0,MNEU
ibrutinib_1.11uM_24h,ibrutinib,1.11 uM,24 h,3,66,69,1,1,1,0,MNEU
pazopanib_1.11uM_24h,pazopanib,1.11 uM,24 h,3,66,69,1,2,1,1,MNEU
BS-181_1.11uM_24h,BS-181,1.11 uM,24 h,3,66,69,1,4,4,0,MNEU
quizartinib_1.11uM_24h,quizartinib,1.11 uM,24 h,3,66,69,1,4,1,3,MNEU
masitinib_1.11uM_24h,masitinib,1.11 uM,24 h,3,66,69,1,2,2,0,MNEU
doramapimod_1.11uM_24h,doramapimod,1.11 uM,24 h,3,66,69,1,1,0,1,MNEU
AST-1306_1.11uM_24h,AST-1306,1.11 uM,24 h,3,66,69,1,6,3,3,MNEU
motesanib_1.11uM_24h,motesanib,1.11 uM,24 h,3,66,69,1,2,1,1,MNEU
idelalisib_1.11uM_24h,idelalisib,1.11 uM,24 h,3,66,69,1,292,140,152,MNEU
cabozantinib_1.11uM_24h,cabozantinib,1.11 uM,24 h,3,66,69,1,11,6,5,MNEU
TPCA-1_1.11uM_24h,TPCA-1,1.11 uM,24 h,3,66,69,1,12,10,2,MNEU
sunitinib_1.11uM_24h,sunitinib,1.11 uM,24 h,3,66,69,1,15,13,2,MNEU
KW-2449_1.11uM_24h,KW-2449,1.11 uM,24 h,3,66,69,1,9,6,3,MNEU
CGP-60474_1.11uM_24h,CGP-60474,1.11 uM,24 h,3,66,69,1,615,271,344,MNEU
bosutinib_1.11uM_24h,bosutinib,1.11 uM,24 h,3,66,69,1,2,1,1,MNEU
PD-0325901_1.11uM_24h,PD-0325901,1.11 uM,24 h,3,66,69,1,40,29,11,MNEU
PF-04217903_1.11uM_24h,PF-04217903,1.11 uM,24 h,3,66,69,1,8,5,3,MNEU
GDC-0068_1.11uM_24h,GDC-0068,1.11 uM,24 h,3,66,69,1,11,7,4,MNEU
vandetanib_3.33uM_24h,vandetanib,3.33 uM,24 h,3,66,69,1,59,31,28,MNEU
ibrutinib_3.33uM_24h,ibrutinib,3.33 uM,24 h,3,66,69,1,2,1,1,MNEU
dacomitinib_3.33uM_24h,dacomitinib,3.33 uM,24 h,3,66,69,1,7,6,1,MNEU
WZ-4002_3.33uM_24h,WZ-4002,3.33 uM,24 h,3,66,69,1,21,15,6,MNEU
dinaciclib_3.33uM_24h,dinaciclib,3.33 uM,24 h,3,66,69,1,566,272,294,MNEU
SGI-1776_3.33uM_24h,SGI-1776,3.33 uM,24 h,3,66,69,1,0,0,0,MNEU
tivantinib_3.33uM_24h,tivantinib,3.33 uM,24 h,3,66,69,1,2,1,1,MNEU
everolimus_3.33uM_24h,everolimus,3.33 uM,24 h,3,66,69,1,39,6,33,MNEU
AZ-628_3.33uM_24h,AZ-628,3.33 uM,24 h,3,66,69,1,27,12,15,MNEU
rebastinib_3.33uM_24h,rebastinib,3.33 uM,24 h,3,66,69,1,32,11,21,MNEU
NVP-TAE226_3.33uM_24h,NVP-TAE226,3.33 uM,24 h,3,66,69,1,65,29,36,MNEU
amuvatinib_3.33uM_24h,amuvatinib,3.33 uM,24 h,3,66,69,1,6,4,2,MNEU
PD-0325901_3.33uM_24h,PD-0325901,3.33 uM,24 h,3,66,69,1,22,16,6,MNEU
CGP-60474_3.33uM_24h,CGP-60474,3.33 uM,24 h,3,66,69,1,569,267,302,MNEU
NVP-BGJ398_3.33uM_24h,NVP-BGJ398,3.33 uM,24 h,3,66,69,1,63,48,15,MNEU
BS-181_3.33uM_24h,BS-181,3.33 uM,24 h,3,66,69,1,36,30,6,MNEU
KW-2449_3.33uM_24h,KW-2449,3.33 uM,24 h,3,66,69,1,4,3,1,MNEU
motesanib_3.33uM_24h,motesanib,3.33 uM,24 h,3,66,69,1,1,1,0,MNEU
SAR-245409_3.33uM_24h,SAR-245409,3.33 uM,24 h,3,66,69,1,13,5,8,MNEU
sunitinib_3.33uM_24h,sunitinib,3.33 uM,24 h,3,66,69,1,34,24,10,MNEU
SB-216763_3.33uM_24h,SB-216763,3.33 uM,24 h,3,66,69,1,32,21,11,MNEU
pazopanib_3.33uM_24h,pazopanib,3.33 uM,24 h,3,66,69,1,6,4,2,MNEU
quizartinib_3.33uM_24h,quizartinib,3.33 uM,24 h,3,66,69,1,14,6,8,MNEU
PF-04217903_3.33uM_24h,PF-04217903,3.33 uM,24 h,3,66,69,1,4,3,1,MNEU
BIX-02189_3.33uM_24h,BIX-02189,3.33 uM,24 h,3,66,69,1,1,0,1,MNEU
BMS-777607_3.33uM_24h,BMS-777607,3.33 uM,24 h,3,66,69,1,7,6,1,MNEU
GDC-0068_3.33uM_24h,GDC-0068,3.33 uM,24 h,3,66,69,1,24,8,16,MNEU
PHA-767491_3.33uM_24h,PHA-767491,3.33 uM,24 h,3,66,69,1,412,198,214,MNEU
cabozantinib_3.33uM_24h,cabozantinib,3.33 uM,24 h,3,66,69,1,8,5,3,MNEU
AST-1306_3.33uM_24h,AST-1306,3.33 uM,24 h,3,66,69,1,0,0,0,MNEU
masitinib_3.33uM_24h,masitinib,3.33 uM,24 h,3,66,69,1,4,0,4,MNEU
bosutinib_3.33uM_24h,bosutinib,3.33 uM,24 h,3,66,69,1,31,24,7,MNEU
SB-525334_3.33uM_24h,SB-525334,3.33 uM,24 h,3,66,69,1,10,4,6,MNEU
idelalisib_3.33uM_24h,idelalisib,3.33 uM,24 h,3,66,69,1,146,68,78,MNEU
dasatinib_3.33uM_24h,dasatinib,3.33 uM,24 h,3,66,69,1,25,13,12,MNEU
TPCA-1_3.33uM_24h,TPCA-1,3.33 uM,24 h,3,66,69,1,33,22,11,MNEU
doramapimod_3.33uM_24h,doramapimod,3.33 uM,24 h,3,66,69,1,0,0,0,MNEU
tivozanib_3.33uM_24h,tivozanib,3.33 uM,24 h,3,66,69,1,5,3,2,MNEU
FR-180204_3.33uM_24h,FR-180204,3.33 uM,24 h,3,66,69,1,1,1,0,MNEU
AZD-9291_10uM_24h,AZD-9291,10 uM,24 h,3,66,69,1,144,68,76,MNEU
ALW-II-49-7_10uM_24h,ALW-II-49-7,10 uM,24 h,3,66,69,1,2,1,1,MNEU
XMD-885_10uM_24h,XMD-885,10 uM,24 h,3,66,69,1,93,60,33,MNEU
A-66_10uM_24h,A-66,10 uM,24 h,3,66,69,1,8,4,4,MNEU
AT-7867_10uM_24h,AT-7867,10 uM,24 h,3,66,69,1,149,64,85,MNEU
AZD-4547_10uM_24h,AZD-4547,10 uM,24 h,3,66,69,1,200,85,115,MNEU
HG-14-10-04_10uM_24h,HG-14-10-04,10 uM,24 h,3,66,69,1,233,95,138,MNEU
KIN001-266_10uM_24h,KIN001-266,10 uM,24 h,3,66,69,1,29,27,2,MNEU
HG-9-91-01_10uM_24h,HG-9-91-01,10 uM,24 h,3,66,69,1,77,38,39,MNEU
BMS-509744_10uM_24h,BMS-509744,10 uM,24 h,3,66,69,1,13,9,4,MNEU
BRD-K68336408_10uM_24h,BRD-K68336408,10 uM,24 h,3,66,69,1,4,2,2,MNEU
MLN-0128_10uM_24h,MLN-0128,10 uM,24 h,3,66,69,1,80,28,52,MNEU
GSK-1059615_10uM_24h,GSK-1059615,10 uM,24 h,3,66,69,1,80,32,48,MNEU
KIN001-244_10uM_24h,KIN001-244,10 uM,24 h,3,66,69,1,7,4,3,MNEU
WZ-7043_10uM_24h,WZ-7043,10 uM,24 h,3,66,69,1,5,5,0,MNEU
BRD-K09991945_10uM_24h,BRD-K09991945,10 uM,24 h,3,66,69,1,11,9,2,MNEU
KIN001-270_10uM_24h,KIN001-270,10 uM,24 h,3,66,69,1,1,0,1,MNEU
A-66_0.04uM_24h,A-66,0.04 uM,24 h,3,66,69,1,52,23,29,MNEU
GSK-1059615_0.04uM_24h,GSK-1059615,0.04 uM,24 h,3,66,69,1,6,1,5,MNEU
BRD-K09991945_0.04uM_24h,BRD-K09991945,0.04 uM,24 h,3,66,69,1,2,1,1,MNEU
KIN001-270_0.04uM_24h,KIN001-270,0.04 uM,24 h,3,66,69,1,2,2,0,MNEU
ALW-II-49-7_0.04uM_24h,ALW-II-49-7,0.04 uM,24 h,3,66,69,1,6,3,3,MNEU
MLN-0128_0.04uM_24h,MLN-0128,0.04 uM,24 h,3,66,69,1,43,10,33,MNEU
BRD-K68336408_0.04uM_24h,BRD-K68336408,0.04 uM,24 h,3,66,69,1,3,3,0,MNEU
HG-14-10-04_0.04uM_24h,HG-14-10-04,0.04 uM,24 h,3,66,69,1,2,1,1,MNEU
AT-7867_0.04uM_24h,AT-7867,0.04 uM,24 h,3,66,69,1,1,1,0,MNEU
BGT-226_0.04uM_24h,BGT-226,0.04 uM,24 h,3,66,69,1,96,40,56,MNEU
WZ-7043_0.04uM_24h,WZ-7043,0.04 uM,24 h,3,66,69,1,1,0,1,MNEU
AZD-9291_0.04uM_24h,AZD-9291,0.04 uM,24 h,3,66,69,1,0,0,0,MNEU
XMD-885_0.04uM_24h,XMD-885,0.04 uM,24 h,3,66,69,1,21,9,12,MNEU
BMS-509744_0.04uM_24h,BMS-509744,0.04 uM,24 h,3,66,69,1,20,9,11,MNEU
AZD-4547_0.04uM_24h,AZD-4547,0.04 uM,24 h,3,66,69,1,1,1,0,MNEU
KIN001-266_0.04uM_24h,KIN001-266,0.04 uM,24 h,3,66,69,1,8,2,6,MNEU
KIN001-244_0.04uM_24h,KIN001-244,0.04 uM,24 h,3,66,69,1,1,0,1,MNEU
HG-9-91-01_0.04uM_24h,HG-9-91-01,0.04 uM,24 h,3,66,69,1,2,1,1,MNEU
ALW-II-49-7_0.12uM_24h,ALW-II-49-7,0.12 uM,24 h,3,66,69,1,10,7,3,MNEU
AZD-9291_0.12uM_24h,AZD-9291,0.12 uM,24 h,3,66,69,1,5,3,2,MNEU
A-66_0.12uM_24h,A-66,0.12 uM,24 h,3,66,69,1,72,44,28,MNEU
KIN001-270_0.12uM_24h,KIN001-270,0.12 uM,24 h,3,66,69,1,2,0,2,MNEU
BRD-K09991945_0.12uM_24h,BRD-K09991945,0.12 uM,24 h,3,66,69,1,0,0,0,MNEU
BGT-226_0.12uM_24h,BGT-226,0.12 uM,24 h,3,66,69,1,85,43,42,MNEU
GSK-1059615_0.12uM_24h,GSK-1059615,0.12 uM,24 h,3,66,69,1,4,2,2,MNEU
HG-14-10-04_0.12uM_24h,HG-14-10-04,0.12 uM,24 h,3,66,69,1,10,3,7,MNEU
AT-7867_0.12uM_24h,AT-7867,0.12 uM,24 h,3,66,69,1,6,5,1,MNEU
BRD-K68336408_0.12uM_24h,BRD-K68336408,0.12 uM,24 h,3,66,69,1,1,1,0,MNEU
KIN001-266_0.12uM_24h,KIN001-266,0.12 uM,24 h,3,66,69,1,1,0,1,MNEU
HG-9-91-01_0.12uM_24h,HG-9-91-01,0.12 uM,24 h,3,66,69,1,9,5,4,MNEU
KIN001-244_0.12uM_24h,KIN001-244,0.12 uM,24 h,3,66,69,1,16,4,12,MNEU
MLN-0128_0.12uM_24h,MLN-0128,0.12 uM,24 h,3,66,69,1,46,17,29,MNEU
BMS-509744_0.12uM_24h,BMS-509744,0.12 uM,24 h,3,66,69,1,2,1,1,MNEU
XMD-885_0.12uM_24h,XMD-885,0.12 uM,24 h,3,66,69,1,13,5,8,MNEU
WZ-7043_0.12uM_24h,WZ-7043,0.12 uM,24 h,3,66,69,1,2,1,1,MNEU
OTS-167_0.37uM_24h,OTS-167,0.37 uM,24 h,3,66,69,1,572,257,315,MNEU
XMD-885_0.37uM_24h,XMD-885,0.37 uM,24 h,3,66,69,1,30,21,9,MNEU
ALW-II-49-7_0.37uM_24h,ALW-II-49-7,0.37 uM,24 h,3,66,69,1,6,2,4,MNEU
BRD-K68336408_0.37uM_24h,BRD-K68336408,0.37 uM,24 h,3,66,69,1,10,3,7,MNEU
AZD-9291_0.37uM_24h,AZD-9291,0.37 uM,24 h,3,66,69,1,3,1,2,MNEU
KIN001-270_0.37uM_24h,KIN001-270,0.37 uM,24 h,3,66,69,1,3,1,2,MNEU
HG-9-91-01_0.37uM_24h,HG-9-91-01,0.37 uM,24 h,3,66,69,1,5,3,2,MNEU
BMS-509744_0.37uM_24h,BMS-509744,0.37 uM,24 h,3,66,69,1,2,1,1,MNEU
AZD-4547_0.37uM_24h,AZD-4547,0.37 uM,24 h,3,66,69,1,4,3,1,MNEU
WZ-7043_0.37uM_24h,WZ-7043,0.37 uM,24 h,3,66,69,1,8,5,3,MNEU
KIN001-244_0.37uM_24h,KIN001-244,0.37 uM,24 h,3,66,69,1,27,3,24,MNEU
AT-7867_0.37uM_24h,AT-7867,0.37 uM,24 h,3,66,69,1,3,2,1,MNEU
BRD-K09991945_0.37uM_24h,BRD-K09991945,0.37 uM,24 h,3,66,69,1,1,1,0,MNEU
KIN001-266_0.37uM_24h,KIN001-266,0.37 uM,24 h,3,66,69,1,1,1,0,MNEU
HG-14-10-04_0.37uM_24h,HG-14-10-04,0.37 uM,24 h,3,66,69,1,11,3,8,MNEU
MLN-0128_0.37uM_24h,MLN-0128,0.37 uM,24 h,3,66,69,1,58,18,40,MNEU
BGT-226_0.37uM_24h,BGT-226,0.37 uM,24 h,3,66,69,1,125,48,77,MNEU
A-66_0.37uM_24h,A-66,0.37 uM,24 h,3,66,69,1,1,1,0,MNEU
GSK-1059615_0.37uM_24h,GSK-1059615,0.37 uM,24 h,3,66,69,1,8,5,3,MNEU
AT-7867_1.11uM_24h,AT-7867,1.11 uM,24 h,3,66,69,1,6,5,1,MNEU
KIN001-266_1.11uM_24h,KIN001-266,1.11 uM,24 h,3,66,69,1,0,0,0,MNEU
MLN-0128_1.11uM_24h,MLN-0128,1.11 uM,24 h,3,66,69,1,65,22,43,MNEU
KIN001-270_1.11uM_24h,KIN001-270,1.11 uM,24 h,3,66,69,1,4,3,1,MNEU
XMD-885_1.11uM_24h,XMD-885,1.11 uM,24 h,3,66,69,1,14,7,7,MNEU
A-66_1.11uM_24h,A-66,1.11 uM,24 h,3,66,69,1,0,0,0,MNEU
ALW-II-49-7_1.11uM_24h,ALW-II-49-7,1.11 uM,24 h,3,66,69,1,7,2,5,MNEU
HG-9-91-01_1.11uM_24h,HG-9-91-01,1.11 uM,24 h,3,66,69,1,13,9,4,MNEU
AZD-9291_1.11uM_24h,AZD-9291,1.11 uM,24 h,3,66,69,1,11,3,8,MNEU
HG-14-10-04_1.11uM_24h,HG-14-10-04,1.11 uM,24 h,3,66,69,1,51,18,33,MNEU
BGT-226_1.11uM_24h,BGT-226,1.11 uM,24 h,3,66,69,1,196,105,91,MNEU
AZD-4547_1.11uM_24h,AZD-4547,1.11 uM,24 h,3,66,69,1,5,2,3,MNEU
KIN001-244_1.11uM_24h,KIN001-244,1.11 uM,24 h,3,66,69,1,7,3,4,MNEU
WZ-7043_1.11uM_24h,WZ-7043,1.11 uM,24 h,3,66,69,1,2,1,1,MNEU
BRD-K68336408_1.11uM_24h,BRD-K68336408,1.11 uM,24 h,3,66,69,1,18,3,15,MNEU
BMS-509744_1.11uM_24h,BMS-509744,1.11 uM,24 h,3,66,69,1,6,3,3,MNEU
GSK-1059615_1.11uM_24h,GSK-1059615,1.11 uM,24 h,3,66,69,1,106,40,66,MNEU
BRD-K09991945_1.11uM_24h,BRD-K09991945,1.11 uM,24 h,3,66,69,1,14,12,2,MNEU
XMD-885_3.33uM_24h,XMD-885,3.33 uM,24 h,3,66,69,1,44,24,20,MNEU
AZD-4547_3.33uM_24h,AZD-4547,3.33 uM,24 h,3,66,69,1,11,7,4,MNEU
KIN001-266_3.33uM_24h,KIN001-266,3.33 uM,24 h,3,66,69,1,2,0,2,MNEU
OTS-167_3.33uM_24h,OTS-167,3.33 uM,24 h,3,66,69,1,614,280,334,MNEU
HG-9-91-01_3.33uM_24h,HG-9-91-01,3.33 uM,24 h,3,66,69,1,3,3,0,MNEU
AZD-9291_3.33uM_24h,AZD-9291,3.33 uM,24 h,3,66,69,1,12,7,5,MNEU
BRD-K09991945_3.33uM_24h,BRD-K09991945,3.33 uM,24 h,3,66,69,1,4,2,2,MNEU
A-66_3.33uM_24h,A-66,3.33 uM,24 h,3,66,69,1,2,1,1,MNEU
KIN001-244_3.33uM_24h,KIN001-244,3.33 uM,24 h,3,66,69,1,1,1,0,MNEU
ALW-II-49-7_3.33uM_24h,ALW-II-49-7,3.33 uM,24 h,3,66,69,1,56,19,37,MNEU
BMS-509744_3.33uM_24h,BMS-509744,3.33 uM,24 h,3,66,69,1,4,2,2,MNEU
GSK-1059615_3.33uM_24h,GSK-1059615,3.33 uM,24 h,3,66,69,1,79,33,46,MNEU
MLN-0128_3.33uM_24h,MLN-0128,3.33 uM,24 h,3,66,69,1,56,34,22,MNEU
AT-7867_3.33uM_24h,AT-7867,3.33 uM,24 h,3,66,69,1,5,4,1,MNEU
HG-14-10-04_3.33uM_24h,HG-14-10-04,3.33 uM,24 h,3,66,69,1,77,35,42,MNEU
KIN001-270_3.33uM_24h,KIN001-270,3.33 uM,24 h,3,66,69,1,1,0,1,MNEU
WZ-7043_3.33uM_24h,WZ-7043,3.33 uM,24 h,3,66,69,1,4,1,3,MNEU
BRD-K68336408_3.33uM_24h,BRD-K68336408,3.33 uM,24 h,3,66,69,1,6,4,2,MNEU
